Run It Once Poker Hand #45239444:  Omaha Pot Limit (€0.10/€0.20) - 2020/05/24 18:01 UTC [2020/05/24 19:01 CET]
Table ID '45238934' 6-Max Seat #1 is the button
Seat 1: Avery I (€31.61 in chips)
Seat 2: Brad A (€39.70 in chips)
Seat 3: MiamiBlues (€20 in chips)
Seat 4: Curtis B (€49.09 in chips)
Seat 5: Charles A (€18.43 in chips)
Seat 6: Zach Y (€21.78 in chips)
Brad A: posts small blind €0.10
MiamiBlues: posts big blind €0.20
*** HOLE CARDS ***
Dealt to Brad A [7c Jh Qs 9h]
Dealt to MiamiBlues [2s 8h Kh As]
Dealt to Curtis B [9d 7s 4c Qh]
Dealt to Charles A [Ts 6c Ad Td]
Dealt to Zach Y [Ac 3s 2d 3d]
Dealt to Avery I [8d 8s Qc Tc]
Curtis B: folds
Charles A: raises €0.40 to €0.60
Zach Y: folds
Avery I: calls €0.60
Brad A: calls €0.50
MiamiBlues: calls €0.40
*** FLOP *** [5d 9s 4d]
Brad A: checks
MiamiBlues: checks
Charles A: checks
Avery I: checks
*** TURN *** [5d 9s 4d] [4s]
Brad A: checks
MiamiBlues: bets €1.15
Charles A: calls €1.15
Avery I: folds
Brad A: folds
*** RIVER *** [5d 9s 4d 4s] [7d]
MiamiBlues: checks
Charles A: bets €2.25
MiamiBlues: folds
Charles A: mucks hand
*** SHOWDOWN ***
Charles A: mucks hand
Uncalled bet (€2.25) returned to Charles A
Charles A collected €4.49 from pot
*** SUMMARY ***
Total pot €4.70 | Main pot €4.70 | Side pot €0.00 | Rake €0.21
Board [5d 9s 4d 4s 7d]
Seat 4: Curtis B folded before Flop
Seat 6: Zach Y folded before Flop
Seat 1: Avery I (button) folded before River
Seat 2: Brad A (small blind) folded before River
Seat 3: MiamiBlues (big blind) folded during River
Seat 5: Charles A mucked hand and won €4.49


**** **** **** **** **** **** **** ****


Run It Once Poker Hand #45239460:  Omaha Pot Limit (€0.10/€0.20) - 2020/05/24 18:02 UTC [2020/05/24 19:02 CET]
Table ID '45238934' 6-Max Seat #2 is the button
Seat 1: Avery I (€31.01 in chips)
Seat 2: Brad A (€39.10 in chips)
Seat 3: MiamiBlues (€20 in chips)
Seat 4: Curtis B (€49.09 in chips)
Seat 5: Charles A (€21.17 in chips)
Seat 6: Zach Y (€21.78 in chips)
MiamiBlues: posts small blind €0.10
Curtis B: posts big blind €0.20
*** HOLE CARDS ***
Dealt to MiamiBlues [9d 8s Ks Qs]
Dealt to Curtis B [Kd 9s 4c 4d]
Dealt to Charles A [5d 9h 6h Ah]
Dealt to Zach Y [Ac Jc 5s 5h]
Dealt to Avery I [Ts Td 9c 7d]
Dealt to Brad A [3h Qd Jd 7c]
Charles A: folds
Zach Y: raises €0.50 to €0.70
Avery I: calls €0.70
Brad A: folds
MiamiBlues: folds
Curtis B: folds
*** FLOP *** [7h 7s Ad]
Zach Y: bets €0.41
Avery I: calls €0.41
*** TURN *** [7h 7s Ad] [6s]
Zach Y: checks
Avery I: bets €1.21
Zach Y: folds
Avery I: mucks hand
*** SHOWDOWN ***
Avery I: mucks hand
Uncalled bet (€1.21) returned to Avery I
Avery I collected €2.41 from pot
*** SUMMARY ***
Total pot €2.52 | Main pot €2.52 | Side pot €0.00 | Rake €0.11
Board [7h 7s Ad 6s]
Seat 5: Charles A folded before Flop
Seat 2: Brad A (button) folded before Flop
Seat 3: MiamiBlues (small blind) folded before Flop
Seat 4: Curtis B (big blind) folded before Flop
Seat 6: Zach Y folded before River
Seat 1: Avery I mucked hand and won €2.41


**** **** **** **** **** **** **** ****


Run It Once Poker Hand #45239467:  Omaha Pot Limit (€0.10/€0.20) - 2020/05/24 18:03 UTC [2020/05/24 19:03 CET]
Table ID '45238934' 6-Max Seat #3 is the button
Seat 1: Avery I (€32.31 in chips)
Seat 2: Brad A (€39.10 in chips)
Seat 3: MiamiBlues (€20 in chips)
Seat 4: Curtis B (€48.89 in chips)
Seat 5: Charles A (€21.17 in chips)
Seat 6: Zach Y (€20.67 in chips)
Curtis B: posts small blind €0.10
Charles A: posts big blind €0.20
*** HOLE CARDS ***
Dealt to Curtis B [Jh Kh As 6s]
Dealt to Charles A [Jc 6d 7h 5c]
Dealt to Zach Y [Qh 3h 6h 5s]
Dealt to Avery I [Ks Kd Kc 9h]
Dealt to Brad A [Qs Ac 9c 7c]
Dealt to MiamiBlues [8d 8c Qc 6c]
Zach Y: folds
Avery I: folds
Brad A: raises €0.50 to €0.70
MiamiBlues: folds
Curtis B: raises €1.60 to €2.30
Charles A: folds
Brad A: folds
*** SHOWDOWN ***
Curtis B: mucks hand
Uncalled bet (€1.60) returned to Curtis B
Curtis B collected €1.60 from pot
*** SUMMARY ***
Total pot €1.60 | Main pot €1.60 | Side pot €0.00 | Rake €0.00
Seat 6: Zach Y folded before Flop
Seat 1: Avery I folded before Flop
Seat 3: MiamiBlues (button) folded before Flop
Seat 5: Charles A (big blind) folded before Flop
Seat 2: Brad A folded before Flop
Seat 4: Curtis B (small blind) mucked hand and won €1.60


**** **** **** **** **** **** **** ****


Run It Once Poker Hand #45239472:  Omaha Pot Limit (€0.10/€0.20) - 2020/05/24 18:03 UTC [2020/05/24 19:03 CET]
Table ID '45238934' 6-Max Seat #4 is the button
Seat 1: Avery I (€32.31 in chips)
Seat 2: Brad A (€38.40 in chips)
Seat 3: MiamiBlues (€20 in chips)
Seat 4: Curtis B (€49.79 in chips)
Seat 5: Charles A (€20.97 in chips)
Seat 6: Zach Y (€20.67 in chips)
Charles A: posts small blind €0.10
Zach Y: posts big blind €0.20
*** HOLE CARDS ***
Dealt to Charles A [Jc Qc Kh Qd]
Dealt to Zach Y [6h 4s Jd 7h]
Dealt to Avery I [4d Jh 3s 3h]
Dealt to Brad A [As 2h Kc Qh]
Dealt to MiamiBlues [2d 9d 8s 8c]
Dealt to Curtis B [Ks 8d 5s 3d]
Avery I: folds
Brad A: raises €0.50 to €0.70
MiamiBlues: folds
Curtis B: folds
Charles A: raises €1.60 to €2.30
Zach Y: folds
Brad A: calls €1.60
*** FLOP *** [7d Js Ah]
Charles A: bets €2.29
Brad A: calls €2.29
*** TURN *** [7d Js Ah] [6s]
Charles A: bets €8.96
Brad A: folds
Charles A: mucks hand
*** SHOWDOWN ***
Charles A: mucks hand
Uncalled bet (€8.96) returned to Charles A
Charles A collected €8.96 from pot
*** SUMMARY ***
Total pot €9.38 | Main pot €9.38 | Side pot €0.00 | Rake €0.42
Board [7d Js Ah 6s]
Seat 1: Avery I folded before Flop
Seat 3: MiamiBlues folded before Flop
Seat 4: Curtis B (button) folded before Flop
Seat 6: Zach Y (big blind) folded before Flop
Seat 2: Brad A folded before River
Seat 5: Charles A (small blind) mucked hand and won €8.96


**** **** **** **** **** **** **** ****


Run It Once Poker Hand #45241589:  Omaha Pot Limit (€0.10/€0.20) - 2020/05/24 18:04 UTC [2020/05/24 19:04 CET]
Table ID '45238934' 6-Max Seat #5 is the button
Seat 1: Avery I (€32.31 in chips)
Seat 2: Brad A (€33.81 in chips)
Seat 3: MiamiBlues (€20 in chips)
Seat 4: Curtis B (€49.79 in chips)
Seat 5: Charles A (€25.34 in chips)
Seat 6: Zach Y (€20.47 in chips)
Zach Y: posts small blind €0.10
Avery I: posts big blind €0.20
*** HOLE CARDS ***
Dealt to Zach Y [9h Jh 3d 2s]
Dealt to Avery I [6d 7d 2c Qd]
Dealt to Brad A [8c Kc 4d Ts]
Dealt to MiamiBlues [3h 3s 2d 4s]
Dealt to Curtis B [2h 8s Tc Jc]
Dealt to Charles A [6c 5d 9c 4h]
Brad A: folds
MiamiBlues: folds
Curtis B: folds
Charles A: raises €0.50 to €0.70
Zach Y: folds
Avery I: folds
*** SHOWDOWN ***
Charles A: mucks hand
Uncalled bet (€0.50) returned to Charles A
Charles A collected €0.50 from pot
*** SUMMARY ***
Total pot €0.50 | Main pot €0.50 | Side pot €0.00 | Rake €0.00
Seat 2: Brad A folded before Flop
Seat 3: MiamiBlues folded before Flop
Seat 4: Curtis B folded before Flop
Seat 6: Zach Y (small blind) folded before Flop
Seat 1: Avery I (big blind) folded before Flop
Seat 5: Charles A (button) mucked hand and won €0.50


**** **** **** **** **** **** **** ****


Run It Once Poker Hand #45241594:  Omaha Pot Limit (€0.10/€0.20) - 2020/05/24 18:04 UTC [2020/05/24 19:04 CET]
Table ID '45238934' 6-Max Seat #6 is the button
Seat 1: Avery I (€32.11 in chips)
Seat 2: Brad A (€33.81 in chips)
Seat 3: MiamiBlues (€20 in chips)
Seat 4: Curtis B (€49.79 in chips)
Seat 5: Charles A (€25.64 in chips)
Seat 6: Zach Y (€20.37 in chips)
Avery I: posts small blind €0.10
Brad A: posts big blind €0.20
*** HOLE CARDS ***
Dealt to Avery I [Jd 6c 5c 6s]
Dealt to Brad A [Ks 2c Jc Ah]
Dealt to MiamiBlues [3d 3h 4s Qc]
Dealt to Curtis B [4d 8s 5s 7c]
Dealt to Charles A [2d Qd 9d 5h]
Dealt to Zach Y [Kc Kd 9c 2s]
MiamiBlues: folds
Curtis B: folds
Charles A: folds
Zach Y: raises €0.50 to €0.70
Avery I: folds
Brad A: calls €0.50
*** FLOP *** [9s Ac Ts]
Brad A: checks
Zach Y: checks
*** TURN *** [9s Ac Ts] [Kh]
Brad A: bets €1.07
Zach Y: calls €1.07
*** RIVER *** [9s Ac Ts Kh] [8d]
Brad A: checks
Zach Y: bets €2.61
Brad A: calls €2.61
*** SHOWDOWN ***
Zach Y shows [Kc Kd 9c 2s] for Three of Kind [Ac Kh Kd Kc Ts]
Zach Y collected €8.46 from pot
*** SUMMARY ***
Total pot €8.86 | Main pot €8.86 | Side pot €0.00 | Rake €0.40
Board [9s Ac Ts Kh 8d]
Seat 3: MiamiBlues folded before Flop
Seat 4: Curtis B folded before Flop
Seat 5: Charles A folded before Flop
Seat 1: Avery I (small blind) folded before Flop
Seat 6: Zach Y (button) showed [Kc Kd 9c 2s] and won €8.46 with Three of Kind K's and A T
Seat 2: Brad A (big blind) mucked [Ks 2c Jc Ah] and lost


**** **** **** **** **** **** **** ****


Run It Once Poker Hand #45241611:  Omaha Pot Limit (€0.10/€0.20) - 2020/05/24 18:06 UTC [2020/05/24 19:06 CET]
Table ID '45238934' 6-Max Seat #1 is the button
Seat 1: Avery I (€32.01 in chips)
Seat 2: Brad A (€29.43 in chips)
Seat 3: MiamiBlues (€20 in chips)
Seat 4: Curtis B (€49.79 in chips)
Seat 5: Charles A (€25.64 in chips)
Seat 6: Zach Y (€24.45 in chips)
Brad A: posts small blind €0.10
MiamiBlues: posts big blind €0.20
*** HOLE CARDS ***
Dealt to Brad A [7s 7d 6d 3h]
Dealt to MiamiBlues [3d 4h Kh 6h]
Dealt to Curtis B [8h 2h Qc 7c]
Dealt to Charles A [Jh Ac Tc Kd]
Dealt to Zach Y [8d 9h 9c 2c]
Dealt to Avery I [8c Qh 2d Jd]
Curtis B: folds
Charles A: raises €0.50 to €0.70
Zach Y: folds
Avery I: folds
Brad A: folds
MiamiBlues: folds
*** SHOWDOWN ***
Charles A: mucks hand
Uncalled bet (€0.50) returned to Charles A
Charles A collected €0.50 from pot
*** SUMMARY ***
Total pot €0.50 | Main pot €0.50 | Side pot €0.00 | Rake €0.00
Seat 4: Curtis B folded before Flop
Seat 6: Zach Y folded before Flop
Seat 1: Avery I (button) folded before Flop
Seat 2: Brad A (small blind) folded before Flop
Seat 3: MiamiBlues (big blind) folded before Flop
Seat 5: Charles A mucked hand and won €0.50


**** **** **** **** **** **** **** ****


Run It Once Poker Hand #45241618:  Omaha Pot Limit (€0.10/€0.20) - 2020/05/24 18:06 UTC [2020/05/24 19:06 CET]
Table ID '45238934' 6-Max Seat #2 is the button
Seat 1: Avery I (€32.01 in chips)
Seat 2: Brad A (€29.33 in chips)
Seat 3: MiamiBlues (€20 in chips)
Seat 4: Curtis B (€49.79 in chips)
Seat 5: Charles A (€25.94 in chips)
Seat 6: Zach Y (€24.45 in chips)
MiamiBlues: posts small blind €0.10
Curtis B: posts big blind €0.20
*** HOLE CARDS ***
Dealt to MiamiBlues [5s Jd 4c 7s]
Dealt to Curtis B [Ac 9h 8h 6c]
Dealt to Charles A [Ts Js Jh Qc]
Dealt to Zach Y [Td Qd Ks 8s]
Dealt to Avery I [6d Ad Tc 7h]
Dealt to Brad A [8d 2h 2d Qs]
Charles A: raises €0.50 to €0.70
Zach Y: raises €1.70 to €2.40
Avery I: folds
Brad A: folds
MiamiBlues: folds
Curtis B: folds
Charles A: calls €1.70
*** FLOP *** [As Qh 9s]
Charles A: checks
Zach Y: bets €3.65
Charles A: calls €3.65
*** TURN *** [As Qh 9s] [6h]
Charles A: checks
Zach Y: bets €11.84
Charles A: calls €11.84
*** RIVER *** [As Qh 9s 6h] [8c]
Charles A: bets €8.05
Zach Y: folds
Charles A: mucks hand
*** SHOWDOWN ***
Charles A: mucks hand
Uncalled bet (€8.05) returned to Charles A
Charles A collected €34.46 from pot
*** SUMMARY ***
Total pot €36.08 | Main pot €36.08 | Side pot €0.00 | Rake €1.62
Board [As Qh 9s 6h 8c]
Seat 1: Avery I folded before Flop
Seat 2: Brad A (button) folded before Flop
Seat 3: MiamiBlues (small blind) folded before Flop
Seat 4: Curtis B (big blind) folded before Flop
Seat 6: Zach Y folded during River
Seat 5: Charles A mucked hand and won €34.46


**** **** **** **** **** **** **** ****


Run It Once Poker Hand #45241640:  Omaha Pot Limit (€0.10/€0.20) - 2020/05/24 18:07 UTC [2020/05/24 19:07 CET]
Table ID '45238934' 6-Max Seat #3 is the button
Seat 1: Avery I (€32.01 in chips)
Seat 2: Brad A (€29.33 in chips)
Seat 3: MiamiBlues (€20 in chips)
Seat 4: Curtis B (€49.59 in chips)
Seat 5: Charles A (€42.51 in chips)
Seat 6: Zach Y (€20 in chips)
Curtis B: posts small blind €0.10
Charles A: posts big blind €0.20
*** HOLE CARDS ***
STP added: €0.80
Dealt to Curtis B [3h 2c 3c 9h]
Dealt to Charles A [Ks Ah Qc Js]
Dealt to Zach Y [6h 6s 7d Kh]
Dealt to Avery I [Qh 5s Kc Td]
Dealt to Brad A [8s 6d 9c Tc]
Dealt to MiamiBlues [4s Jc 8d 8h]
Zach Y: folds
Avery I: folds
Brad A: raises €0.50 to €0.70
MiamiBlues: folds
Curtis B: folds
Charles A: raises €1.50 to €2.20
Brad A: raises €2.40 to €4.60
Charles A: calls €2.40
*** FLOP *** [Jd Ac 5d]
Charles A: checks
Brad A: bets €3.80
Charles A: calls €3.80
*** TURN *** [Jd Ac 5d] [2h]
Charles A: checks
Brad A: bets €8.47
Charles A: folds
Brad A: mucks hand
*** SHOWDOWN ***
Brad A: mucks hand
Uncalled bet (€8.47) returned to Brad A
Brad A collected €16.94 from pot
*** SUMMARY ***
Total pot €17.70 | Main pot €16.90 | Side pot €0.00 | STP €0.80 | Rake €0.76
Board [Jd Ac 5d 2h]
Seat 6: Zach Y folded before Flop
Seat 1: Avery I folded before Flop
Seat 3: MiamiBlues (button) folded before Flop
Seat 4: Curtis B (small blind) folded before Flop
Seat 5: Charles A (big blind) folded before River
Seat 2: Brad A mucked hand and won €16.94


**** **** **** **** **** **** **** ****


Run It Once Poker Hand #45241669:  Omaha Pot Limit (€0.10/€0.20) - 2020/05/24 18:09 UTC [2020/05/24 19:09 CET]
Table ID '45238934' 6-Max Seat #4 is the button
Seat 1: Avery I (€32.01 in chips)
Seat 2: Brad A (€37.87 in chips)
Seat 3: MiamiBlues (€20 in chips)
Seat 4: Curtis B (€49.49 in chips)
Seat 5: Charles A (€34.11 in chips)
Seat 6: Cassandra O (€20 in chips)
Charles A: posts small blind €0.10
Cassandra O: posts big blind €0.20
*** HOLE CARDS ***
STP added: €0.60
Dealt to Charles A [2s Tc Td 3c]
Dealt to Cassandra O [6c 2d Kh 4h]
Dealt to Avery I [7s 9h 3s 5d]
Dealt to Brad A [9c 9s 3d Qd]
Dealt to MiamiBlues [Ks Jd Qs Jc]
Dealt to Curtis B [3h Qc 4c Ah]
Avery I: folds
Brad A: folds
MiamiBlues: raises €0.50 to €0.70
Curtis B: calls €0.70
Charles A: calls €0.60
Cassandra O: folds
*** FLOP *** [5c 7h 7c]
Charles A: checks
MiamiBlues: checks
Curtis B: bets €1.40
Charles A: calls €1.40
MiamiBlues: folds
*** TURN *** [5c 7h 7c] [5h]
Charles A: checks
Curtis B: bets €4.10
Charles A: folds
Curtis B: mucks hand
*** SHOWDOWN ***
Curtis B: mucks hand
Uncalled bet (€4.10) returned to Curtis B
Curtis B collected €5.47 from pot
*** SUMMARY ***
Total pot €5.70 | Main pot €5.10 | Side pot €0.00 | STP €0.60 | Rake €0.23
Board [5c 7h 7c 5h]
Seat 1: Avery I folded before Flop
Seat 2: Brad A folded before Flop
Seat 6: Cassandra O (big blind) folded before Flop
Seat 3: MiamiBlues folded before Turn
Seat 5: Charles A (small blind) folded before River
Seat 4: Curtis B (button) mucked hand and won €5.47


**** **** **** **** **** **** **** ****


Run It Once Poker Hand #45241691:  Omaha Pot Limit (€0.10/€0.20) - 2020/05/24 18:10 UTC [2020/05/24 19:10 CET]
Table ID '45238934' 6-Max Seat #5 is the button
Seat 1: Avery I (€32.01 in chips)
Seat 2: Brad A (€37.87 in chips)
Seat 3: MiamiBlues (€20 in chips)
Seat 4: Curtis B (€52.86 in chips)
Seat 5: Charles A (€32.01 in chips)
Seat 6: Cassandra O (€20 in chips)
Cassandra O: posts small blind €0.10
Avery I: posts big blind €0.20
*** HOLE CARDS ***
Dealt to Cassandra O [7c 9s 3h Qh]
Dealt to Avery I [7h Ac 8h Kc]
Dealt to Brad A [Th 8s 2c Kh]
Dealt to MiamiBlues [Qd 6h 4s 5h]
Dealt to Curtis B [2d 3c 4h 7s]
Dealt to Charles A [6c 5d 9h Js]
Brad A: folds
MiamiBlues: folds
Curtis B: folds
Charles A: folds
Cassandra O: folds
*** SHOWDOWN ***
Avery I: mucks hand
Avery I collected €0.30 from pot
*** SUMMARY ***
Total pot €0.30 | Main pot €0.30 | Side pot €0.00 | Rake €0.00
Seat 2: Brad A folded before Flop
Seat 3: MiamiBlues folded before Flop
Seat 4: Curtis B folded before Flop
Seat 5: Charles A (button) folded before Flop
Seat 6: Cassandra O (small blind) folded before Flop
Seat 1: Avery I (big blind) mucked hand and won €0.30


**** **** **** **** **** **** **** ****


Run It Once Poker Hand #45241693:  Omaha Pot Limit (€0.10/€0.20) - 2020/05/24 18:10 UTC [2020/05/24 19:10 CET]
Table ID '45238934' 6-Max Seat #6 is the button
Seat 1: Avery I (€32.11 in chips)
Seat 2: Brad A (€37.87 in chips)
Seat 3: MiamiBlues (€20 in chips)
Seat 4: Curtis B (€52.86 in chips)
Seat 5: Charles A (€32.01 in chips)
Seat 6: Cassandra O (€20 in chips)
Avery I: posts small blind €0.10
Brad A: posts big blind €0.20
*** HOLE CARDS ***
Dealt to Avery I [Ts As 3d 8d]
Dealt to Brad A [2d 2h 3c 8c]
Dealt to MiamiBlues [Tc Th Qh Td]
Dealt to Curtis B [Qd 7h Ks 4h]
Dealt to Charles A [9d 7s Ad Jh]
Dealt to Cassandra O [5h Qs 6h 6d]
MiamiBlues: folds
Curtis B: folds
Charles A: raises €0.50 to €0.70
Cassandra O: folds
Avery I: folds
Brad A: folds
*** SHOWDOWN ***
Charles A: mucks hand
Uncalled bet (€0.50) returned to Charles A
Charles A collected €0.50 from pot
*** SUMMARY ***
Total pot €0.50 | Main pot €0.50 | Side pot €0.00 | Rake €0.00
Seat 3: MiamiBlues folded before Flop
Seat 4: Curtis B folded before Flop
Seat 6: Cassandra O (button) folded before Flop
Seat 1: Avery I (small blind) folded before Flop
Seat 2: Brad A (big blind) folded before Flop
Seat 5: Charles A mucked hand and won €0.50


**** **** **** **** **** **** **** ****


Run It Once Poker Hand #45241701:  Omaha Pot Limit (€0.10/€0.20) - 2020/05/24 18:11 UTC [2020/05/24 19:11 CET]
Table ID '45238934' 6-Max Seat #1 is the button
Seat 1: Avery I (€32.01 in chips)
Seat 2: Brad A (€37.67 in chips)
Seat 3: MiamiBlues (€20 in chips)
Seat 4: Curtis B (€52.86 in chips)
Seat 5: Charles A (€32.31 in chips)
Seat 6: Cassandra O (€20 in chips)
Brad A: posts small blind €0.10
MiamiBlues: posts big blind €0.20
*** HOLE CARDS ***
Dealt to Brad A [Tc Kh Jc Qs]
Dealt to MiamiBlues [4h 7h 2d 7d]
Dealt to Curtis B [Th 5s Ks 3d]
Dealt to Charles A [5d 3h Qc 9s]
Dealt to Cassandra O [Qh 9d Jd Ts]
Dealt to Avery I [5c 8s 4s 6c]
Curtis B: folds
Charles A: folds
Cassandra O: raises €0.50 to €0.70
Avery I: raises €1.70 to €2.40
Brad A: calls €2.30
MiamiBlues: folds
Cassandra O: calls €1.70
*** FLOP *** [Qd 9c Kc]
Brad A: checks
Cassandra O: bets €7.07
Avery I: folds
Brad A: raises €21.21 to €28.28
Cassandra O: calls €10.53 and is all-in
*** TURN *** [Qd 9c Kc] [Jh]
*** RIVER *** [Qd 9c Kc Jh] [3c]
*** SHOWDOWN ***
Brad A shows [Tc Kh Jc Qs] for Flush [Kc Jc Tc 9c 3c]
Uncalled bet (€10.68) returned to Brad A
Brad A collected €40.68 from pot
*** SUMMARY ***
Total pot €42.60 | Main pot €42.60 | Side pot €0.00 | Rake €1.92
Board [Qd 9c Kc Jh 3c]
Seat 4: Curtis B folded before Flop
Seat 5: Charles A folded before Flop
Seat 3: MiamiBlues (big blind) folded before Flop
Seat 1: Avery I (button) folded before Turn
Seat 2: Brad A (small blind) showed [Tc Kh Jc Qs] and won €40.68 with Flush high Kc
Seat 6: Cassandra O mucked [Qh 9d Jd Ts] and lost


**** **** **** **** **** **** **** ****


Run It Once Poker Hand #45241720:  Omaha Pot Limit (€0.10/€0.20) - 2020/05/24 18:12 UTC [2020/05/24 19:12 CET]
Table ID '45238934' 6-Max Seat #2 is the button
Seat 1: Avery I (€29.61 in chips)
Seat 2: Brad A (€58.35 in chips)
Seat 3: MiamiBlues (€20 in chips)
Seat 4: Curtis B (€52.86 in chips)
Seat 5: Charles A (€32.31 in chips)
Seat 6: Cassandra O (€20 in chips)
MiamiBlues: posts small blind €0.10
Curtis B: posts big blind €0.20
*** HOLE CARDS ***
STP added: €0.60
Dealt to MiamiBlues [8h 2c Kd 3h]
Dealt to Curtis B [6d 6h 9d Qs]
Dealt to Charles A [3c 7d 9s Qd]
Dealt to Cassandra O [7h Jh Qc 3s]
Dealt to Avery I [Th 3d Jc 6c]
Dealt to Brad A [Ts 8d 4d 6s]
Charles A: folds
Cassandra O: folds
Avery I: folds
Brad A: raises €0.50 to €0.70
MiamiBlues: folds
Curtis B: folds
*** SHOWDOWN ***
Brad A: mucks hand
Uncalled bet (€0.50) returned to Brad A
Brad A collected €1.10 from pot
*** SUMMARY ***
Total pot €1.10 | Main pot €0.50 | Side pot €0.00 | STP €0.60 | Rake €0.00
Seat 5: Charles A folded before Flop (timeout)
Seat 6: Cassandra O folded before Flop
Seat 1: Avery I folded before Flop
Seat 3: MiamiBlues (small blind) folded before Flop
Seat 4: Curtis B (big blind) folded before Flop
Seat 2: Brad A (button) mucked hand and won €1.10


**** **** **** **** **** **** **** ****


Run It Once Poker Hand #45241729:  Omaha Pot Limit (€0.10/€0.20) - 2020/05/24 18:12 UTC [2020/05/24 19:12 CET]
Table ID '45238934' 6-Max Seat #3 is the button
Seat 1: Avery I (€29.61 in chips)
Seat 2: Brad A (€59.25 in chips)
Seat 3: MiamiBlues (€20 in chips)
Seat 4: Curtis B (€52.66 in chips)
Seat 5: Charles A (€32.31 in chips)
Seat 6: Cassandra O (€20 in chips)
Curtis B: posts small blind €0.10
Charles A: posts big blind €0.20
*** HOLE CARDS ***
Dealt to Curtis B [5d 6h 2d Ah]
Dealt to Charles A [6d Qh Qc 9s]
Dealt to Cassandra O [3s Ts 2s 4h]
Dealt to Avery I [3h 5h Qs Tc]
Dealt to Brad A [8c Ad 5s 7c]
Dealt to MiamiBlues [8d 6c 9d 2h]
Cassandra O: folds
Avery I: folds
Brad A: folds
MiamiBlues: raises €0.50 to €0.70
Curtis B: folds
Charles A: calls €0.50
*** FLOP *** [7h 8s 3d]
Charles A: checks
MiamiBlues: bets €0.72
Charles A: calls €0.72
*** TURN *** [7h 8s 3d] [Jd]
Charles A: checks
MiamiBlues: bets €2
Charles A: folds
MiamiBlues: mucks hand
*** SHOWDOWN ***
MiamiBlues: mucks hand
Uncalled bet (€2) returned to MiamiBlues
MiamiBlues collected €2.81 from pot
*** SUMMARY ***
Total pot €2.94 | Main pot €2.94 | Side pot €0.00 | Rake €0.13
Board [7h 8s 3d Jd]
Seat 6: Cassandra O folded before Flop
Seat 1: Avery I folded before Flop
Seat 2: Brad A folded before Flop
Seat 4: Curtis B (small blind) folded before Flop
Seat 5: Charles A (big blind) folded before River (timeout)
Seat 3: MiamiBlues (button) mucked hand and won €2.81


**** **** **** **** **** **** **** ****


Run It Once Poker Hand #45241739:  Omaha Pot Limit (€0.10/€0.20) - 2020/05/24 18:14 UTC [2020/05/24 19:14 CET]
Table ID '45238934' 6-Max Seat #4 is the button
Seat 1: Avery I (€29.61 in chips)
Seat 2: Brad A (€59.25 in chips)
Seat 3: MiamiBlues (€21.39 in chips)
Seat 4: Curtis B (€52.56 in chips)
Seat 6: Cassandra O (€20 in chips)
Cassandra O: posts small blind €0.10
Avery I: posts big blind €0.20
*** HOLE CARDS ***
Dealt to Cassandra O [7d Kh 3s 7s]
Dealt to Avery I [4c 4s 7h 6c]
Dealt to Brad A [Qd Jc 5c Ts]
Dealt to MiamiBlues [Tc 3c Qs 3d]
Dealt to Curtis B [5h Ac 6d 3h]
Brad A: folds
MiamiBlues: folds
Curtis B: folds
Cassandra O: folds
*** SHOWDOWN ***
Avery I: mucks hand
Avery I collected €0.30 from pot
*** SUMMARY ***
Total pot €0.30 | Main pot €0.30 | Side pot €0.00 | Rake €0.00
Seat 2: Brad A folded before Flop
Seat 3: MiamiBlues folded before Flop
Seat 4: Curtis B (button) folded before Flop
Seat 6: Cassandra O (small blind) folded before Flop
Seat 1: Avery I (big blind) mucked hand and won €0.30


**** **** **** **** **** **** **** ****


Run It Once Poker Hand #45241742:  Omaha Pot Limit (€0.10/€0.20) - 2020/05/24 18:14 UTC [2020/05/24 19:14 CET]
Table ID '45238934' 6-Max Seat #6 is the button
Seat 1: Avery I (€29.71 in chips)
Seat 2: Brad A (€59.25 in chips)
Seat 3: MiamiBlues (€21.39 in chips)
Seat 4: Curtis B (€52.56 in chips)
Seat 6: Cassandra O (€20 in chips)
Avery I: posts small blind €0.10
Brad A: posts big blind €0.20
*** HOLE CARDS ***
Dealt to Avery I [8d 7s Ts 9c]
Dealt to Brad A [Js 4h 5c 5d]
Dealt to MiamiBlues [Tc Kh 4d 5h]
Dealt to Curtis B [6h 2s Jc Qc]
Dealt to Cassandra O [Td 2d 7d 6d]
MiamiBlues: folds
Curtis B: folds
Cassandra O: folds
Avery I: raises €0.40 to €0.60
Brad A: folds
*** SHOWDOWN ***
Avery I: mucks hand
Uncalled bet (€0.40) returned to Avery I
Avery I collected €0.40 from pot
*** SUMMARY ***
Total pot €0.40 | Main pot €0.40 | Side pot €0.00 | Rake €0.00
Seat 3: MiamiBlues folded before Flop
Seat 4: Curtis B folded before Flop
Seat 6: Cassandra O (button) folded before Flop
Seat 2: Brad A (big blind) folded before Flop
Seat 1: Avery I (small blind) mucked hand and won €0.40


**** **** **** **** **** **** **** ****


Run It Once Poker Hand #45241744:  Omaha Pot Limit (€0.10/€0.20) - 2020/05/24 18:14 UTC [2020/05/24 19:14 CET]
Table ID '45238934' 6-Max Seat #1 is the button
Seat 1: Avery I (€29.91 in chips)
Seat 2: Brad A (€59.05 in chips)
Seat 3: MiamiBlues (€21.39 in chips)
Seat 4: Curtis B (€52.56 in chips)
Seat 6: Cassandra O (€20 in chips)
Brad A: posts small blind €0.10
MiamiBlues: posts big blind €0.20
*** HOLE CARDS ***
Dealt to Brad A [Jh 5d Ad 8c]
Dealt to MiamiBlues [Qc 9s 7c 4d]
Dealt to Curtis B [3s 8h Tc Ts]
Dealt to Cassandra O [7d 7s 3c 3d]
Dealt to Avery I [8d 4s 2d 2h]
Curtis B: folds
Cassandra O: raises €0.50 to €0.70
Avery I: folds
Brad A: folds
MiamiBlues: folds
*** SHOWDOWN ***
Cassandra O: mucks hand
Uncalled bet (€0.50) returned to Cassandra O
Cassandra O collected €0.50 from pot
*** SUMMARY ***
Total pot €0.50 | Main pot €0.50 | Side pot €0.00 | Rake €0.00
Seat 4: Curtis B folded before Flop
Seat 1: Avery I (button) folded before Flop
Seat 2: Brad A (small blind) folded before Flop
Seat 3: MiamiBlues (big blind) folded before Flop
Seat 6: Cassandra O mucked hand and won €0.50


**** **** **** **** **** **** **** ****


Run It Once Poker Hand #45241751:  Omaha Pot Limit (€0.10/€0.20) - 2020/05/24 18:15 UTC [2020/05/24 19:15 CET]
Table ID '45238934' 6-Max Seat #2 is the button
Seat 1: Avery I (€29.91 in chips)
Seat 2: Brad A (€58.95 in chips)
Seat 3: MiamiBlues (€21.19 in chips)
Seat 4: Curtis B (€52.56 in chips)
Seat 6: Cassandra O (€20.30 in chips)
MiamiBlues: posts small blind €0.10
Curtis B: posts big blind €0.20
*** HOLE CARDS ***
Dealt to MiamiBlues [5c Kc 9c Jh]
Dealt to Curtis B [6c Jd 4h 9h]
Dealt to Cassandra O [3d 3s 7s Ac]
Dealt to Avery I [9s Qd 7h Qc]
Dealt to Brad A [5d Tc Th 5s]
Cassandra O: folds
Avery I: folds
Brad A: raises €0.50 to €0.70
MiamiBlues: folds
Curtis B: folds
*** SHOWDOWN ***
Brad A: mucks hand
Uncalled bet (€0.50) returned to Brad A
Brad A collected €0.50 from pot
*** SUMMARY ***
Total pot €0.50 | Main pot €0.50 | Side pot €0.00 | Rake €0.00
Seat 6: Cassandra O folded before Flop
Seat 1: Avery I folded before Flop
Seat 3: MiamiBlues (small blind) folded before Flop
Seat 4: Curtis B (big blind) folded before Flop
Seat 2: Brad A (button) mucked hand and won €0.50


**** **** **** **** **** **** **** ****


Run It Once Poker Hand #45241754:  Omaha Pot Limit (€0.10/€0.20) - 2020/05/24 18:15 UTC [2020/05/24 19:15 CET]
Table ID '45238934' 6-Max Seat #3 is the button
Seat 1: Avery I (€29.91 in chips)
Seat 2: Brad A (€59.25 in chips)
Seat 3: MiamiBlues (€21.09 in chips)
Seat 4: Curtis B (€52.36 in chips)
Seat 5: Charles A (€30.89 in chips)
Seat 6: Cassandra O (€20.30 in chips)
Curtis B: posts small blind €0.10
Charles A: posts big blind €0.20
*** HOLE CARDS ***
Dealt to Curtis B [2d Ks 5h As]
Dealt to Charles A [Kh Kc 2h Qs]
Dealt to Cassandra O [Td 6c 6s 6d]
Dealt to Avery I [9c Qh Ts 9d]
Dealt to Brad A [8c 4d Ad 2s]
Dealt to MiamiBlues [5d 4h 5c 5s]
Cassandra O: folds
Avery I: folds
Brad A: folds
MiamiBlues: folds
Curtis B: raises €0.40 to €0.60
Charles A: raises €1.20 to €1.80
Curtis B: folds
*** SHOWDOWN ***
Charles A: mucks hand
Uncalled bet (€1.20) returned to Charles A
Charles A collected €1.20 from pot
*** SUMMARY ***
Total pot €1.20 | Main pot €1.20 | Side pot €0.00 | Rake €0.00
Seat 6: Cassandra O folded before Flop
Seat 1: Avery I folded before Flop
Seat 2: Brad A folded before Flop
Seat 3: MiamiBlues (button) folded before Flop
Seat 4: Curtis B (small blind) folded before Flop
Seat 5: Charles A (big blind) mucked hand and won €1.20


**** **** **** **** **** **** **** ****


Run It Once Poker Hand #45241763:  Omaha Pot Limit (€0.10/€0.20) - 2020/05/24 18:15 UTC [2020/05/24 19:15 CET]
Table ID '45238934' 6-Max Seat #4 is the button
Seat 1: Avery I (€29.91 in chips)
Seat 2: Brad A (€59.25 in chips)
Seat 3: MiamiBlues (€21.09 in chips)
Seat 4: Curtis B (€51.76 in chips)
Seat 5: Charles A (€31.49 in chips)
Seat 6: Cassandra O (€20.30 in chips)
Charles A: posts small blind €0.10
Cassandra O: posts big blind €0.20
*** HOLE CARDS ***
Dealt to Charles A [2c 5d 3h 5h]
Dealt to Cassandra O [Jh Td Ad 2d]
Dealt to Avery I [7d 5c 3c 6d]
Dealt to Brad A [Ac 4d Qc 3s]
Dealt to MiamiBlues [Jc Ts 4c 8s]
Dealt to Curtis B [6s Jd Qs 9d]
Avery I: raises €0.50 to €0.70
Brad A: folds
MiamiBlues: folds
Curtis B: folds
Charles A: calls €0.60
Cassandra O: folds
*** FLOP *** [7c Qd 3d]
Charles A: checks
Avery I: bets €1
Charles A: folds
Avery I: mucks hand
*** SHOWDOWN ***
Avery I: mucks hand
Uncalled bet (€1) returned to Avery I
Avery I collected €1.53 from pot
*** SUMMARY ***
Total pot €1.60 | Main pot €1.60 | Side pot €0.00 | Rake €0.07
Board [7c Qd 3d]
Seat 2: Brad A folded before Flop
Seat 3: MiamiBlues folded before Flop
Seat 4: Curtis B (button) folded before Flop
Seat 6: Cassandra O (big blind) folded before Flop
Seat 5: Charles A (small blind) folded before Turn
Seat 1: Avery I mucked hand and won €1.53


**** **** **** **** **** **** **** ****


Run It Once Poker Hand #45241771:  Omaha Pot Limit (€0.10/€0.20) - 2020/05/24 18:16 UTC [2020/05/24 19:16 CET]
Table ID '45238934' 6-Max Seat #5 is the button
Seat 1: Avery I (€30.74 in chips)
Seat 2: Brad A (€59.25 in chips)
Seat 3: MiamiBlues (€21.09 in chips)
Seat 4: Curtis B (€51.76 in chips)
Seat 5: Charles A (€30.79 in chips)
Seat 6: Cassandra O (€20.10 in chips)
Cassandra O: posts small blind €0.10
Avery I: posts big blind €0.20
*** HOLE CARDS ***
Dealt to Cassandra O [4s Qc Kh Ks]
Dealt to Avery I [Ac 9s 3c 7c]
Dealt to Brad A [7h Td 2d 8c]
Dealt to MiamiBlues [5s 9c Qs Th]
Dealt to Curtis B [3d Kd As Jc]
Dealt to Charles A [2c 5h Js 2s]
Brad A: folds
MiamiBlues: folds
Curtis B: raises €0.50 to €0.70
Charles A: folds
Cassandra O: folds
Avery I: folds
*** SHOWDOWN ***
Curtis B: mucks hand
Uncalled bet (€0.50) returned to Curtis B
Curtis B collected €0.50 from pot
*** SUMMARY ***
Total pot €0.50 | Main pot €0.50 | Side pot €0.00 | Rake €0.00
Seat 2: Brad A folded before Flop
Seat 3: MiamiBlues folded before Flop
Seat 5: Charles A (button) folded before Flop
Seat 6: Cassandra O (small blind) folded before Flop
Seat 1: Avery I (big blind) folded before Flop
Seat 4: Curtis B mucked hand and won €0.50


**** **** **** **** **** **** **** ****


Run It Once Poker Hand #45241775:  Omaha Pot Limit (€0.10/€0.20) - 2020/05/24 18:16 UTC [2020/05/24 19:16 CET]
Table ID '45238934' 6-Max Seat #6 is the button
Seat 1: Avery I (€30.54 in chips) - Sitting Out
Seat 2: Brad A (€59.25 in chips)
Seat 3: MiamiBlues (€21.09 in chips)
Seat 4: Curtis B (€52.06 in chips)
Seat 5: Charles A (€30.79 in chips)
Seat 6: Cassandra O (€20 in chips)
Brad A: posts small blind €0.10
MiamiBlues: posts big blind €0.20
*** HOLE CARDS ***
Dealt to Brad A [8h 9c 7h Jd]
Dealt to MiamiBlues [As 7s 8d Ah]
Dealt to Curtis B [3h Jc 5s 5c]
Dealt to Charles A [Td 6s Ks 4h]
Dealt to Cassandra O [8c 2c 7c Kd]
Curtis B: folds
Charles A: raises €0.40 to €0.60
Cassandra O: folds
Brad A: calls €0.50
MiamiBlues: calls €0.40
*** FLOP *** [Ac 4s 4d]
Brad A: checks
MiamiBlues: checks
Charles A: checks
*** TURN *** [Ac 4s 4d] [Js]
Brad A: checks
MiamiBlues: checks
Charles A: bets €0.86
Brad A: folds
MiamiBlues: raises €2.75 to €3.61
Charles A: folds
MiamiBlues: mucks hand
*** SHOWDOWN ***
MiamiBlues: mucks hand
Uncalled bet (€2.75) returned to MiamiBlues
MiamiBlues collected €3.36 from pot
*** SUMMARY ***
Total pot €3.52 | Main pot €3.52 | Side pot €0.00 | Rake €0.16
Board [Ac 4s 4d Js]
Seat 4: Curtis B folded before Flop
Seat 6: Cassandra O (button) folded before Flop
Seat 2: Brad A (small blind) folded before River
Seat 5: Charles A folded before River
Seat 3: MiamiBlues (big blind) mucked hand and won €3.36


**** **** **** **** **** **** **** ****


Run It Once Poker Hand #45241783:  Omaha Pot Limit (€0.10/€0.20) - 2020/05/24 18:17 UTC [2020/05/24 19:17 CET]
Table ID '45238934' 6-Max Seat #2 is the button
Seat 2: Brad A (€58.65 in chips)
Seat 3: MiamiBlues (€22.99 in chips)
Seat 4: Curtis B (€52.06 in chips)
Seat 5: Charles A (€29.33 in chips)
Seat 6: Cassandra O (€20 in chips)
MiamiBlues: posts small blind €0.10
Curtis B: posts big blind €0.20
*** HOLE CARDS ***
Dealt to MiamiBlues [3d Ad Tc 3s]
Dealt to Curtis B [7c Qh Ac 8h]
Dealt to Charles A [Kd 4c Ts 4s]
Dealt to Cassandra O [Kh 9h Qs 8c]
Dealt to Brad A [Kc 7h Js Ah]
Charles A: folds
Cassandra O: raises €0.50 to €0.70
Brad A: calls €0.70
MiamiBlues: folds
Curtis B: calls €0.50
*** FLOP *** [Td 3c 6c]
Curtis B: checks
Cassandra O: checks
Brad A: checks
*** TURN *** [Td 3c 6c] [2s]
Curtis B: bets €1.58
Cassandra O: folds
Brad A: folds
Curtis B: mucks hand
*** SHOWDOWN ***
Curtis B: mucks hand
Uncalled bet (€1.58) returned to Curtis B
Curtis B collected €2.10 from pot
*** SUMMARY ***
Total pot €2.20 | Main pot €2.20 | Side pot €0.00 | Rake €0.10
Board [Td 3c 6c 2s]
Seat 5: Charles A folded before Flop
Seat 3: MiamiBlues (small blind) folded before Flop
Seat 6: Cassandra O folded before River
Seat 2: Brad A (button) folded before River
Seat 4: Curtis B (big blind) mucked hand and won €2.10


**** **** **** **** **** **** **** ****


Run It Once Poker Hand #45241795:  Omaha Pot Limit (€0.10/€0.20) - 2020/05/24 18:18 UTC [2020/05/24 19:18 CET]
Table ID '45238934' 6-Max Seat #3 is the button
Seat 2: Brad A (€57.95 in chips)
Seat 3: MiamiBlues (€22.89 in chips)
Seat 4: Curtis B (€53.46 in chips)
Seat 5: Charles A (€29.33 in chips)
Seat 6: Cassandra O (€20 in chips)
Curtis B: posts small blind €0.10
Charles A: posts big blind €0.20
*** HOLE CARDS ***
Dealt to Curtis B [7s Qh Ks 8h]
Dealt to Charles A [Ah 4h 3d 4d]
Dealt to Cassandra O [Ts Jh Kc 2c]
Dealt to Brad A [8c 5d 3c Qs]
Dealt to MiamiBlues [6d 8d 6s Kh]
Cassandra O: folds
Brad A: folds
MiamiBlues: folds
Curtis B: raises €0.40 to €0.60
Charles A: folds
*** SHOWDOWN ***
Curtis B: mucks hand
Uncalled bet (€0.40) returned to Curtis B
Curtis B collected €0.40 from pot
*** SUMMARY ***
Total pot €0.40 | Main pot €0.40 | Side pot €0.00 | Rake €0.00
Seat 6: Cassandra O folded before Flop
Seat 2: Brad A folded before Flop
Seat 3: MiamiBlues (button) folded before Flop
Seat 5: Charles A (big blind) folded before Flop (timeout)
Seat 4: Curtis B (small blind) mucked hand and won €0.40


**** **** **** **** **** **** **** ****


Run It Once Poker Hand #45241798:  Omaha Pot Limit (€0.10/€0.20) - 2020/05/24 18:18 UTC [2020/05/24 19:18 CET]
Table ID '45238934' 6-Max Seat #4 is the button
Seat 2: Brad A (€57.95 in chips)
Seat 3: MiamiBlues (€22.89 in chips)
Seat 4: Curtis B (€53.66 in chips)
Seat 6: Cassandra O (€20 in chips)
Cassandra O: posts small blind €0.10
Brad A: posts big blind €0.20
*** HOLE CARDS ***
Dealt to Cassandra O [8s Qd Qh 5h]
Dealt to Brad A [As Jc 7c 6d]
Dealt to MiamiBlues [8h 3d 6h 4s]
Dealt to Curtis B [2d 8c 3s 7s]
MiamiBlues: folds
Curtis B: folds
Cassandra O: raises €0.40 to €0.60
Brad A: calls €0.40
*** FLOP *** [5d Kc 7h]
Cassandra O: checks
Brad A: checks
*** TURN *** [5d Kc 7h] [6s]
Cassandra O: checks
Brad A: bets €0.86
Cassandra O: calls €0.86
*** RIVER *** [5d Kc 7h 6s] [4h]
Cassandra O: checks
Brad A: checks
*** SHOWDOWN ***
Cassandra O shows [8s Qd Qh 5h] for Straight [8s 7h 6s 5h 4h]
Cassandra O collected €2.79 from pot
*** SUMMARY ***
Total pot €2.92 | Main pot €2.92 | Side pot €0.00 | Rake €0.13
Board [5d Kc 7h 6s 4h]
Seat 3: MiamiBlues folded before Flop
Seat 4: Curtis B (button) folded before Flop
Seat 6: Cassandra O (small blind) showed [8s Qd Qh 5h] and won €2.79 with Straight 4 to 8
Seat 2: Brad A (big blind) mucked [As Jc 7c 6d] and lost


**** **** **** **** **** **** **** ****


Run It Once Poker Hand #45241810:  Omaha Pot Limit (€0.10/€0.20) - 2020/05/24 18:19 UTC [2020/05/24 19:19 CET]
Table ID '45238934' 6-Max Seat #6 is the button
Seat 2: Brad A (€56.49 in chips)
Seat 3: MiamiBlues (€22.89 in chips)
Seat 4: Curtis B (€53.66 in chips)
Seat 6: Cassandra O (€21.33 in chips)
Brad A: posts small blind €0.10
MiamiBlues: posts big blind €0.20
*** HOLE CARDS ***
Dealt to Brad A [Jd Ks Jh 2s]
Dealt to MiamiBlues [8d 5h 4c Ah]
Dealt to Curtis B [Tc 8s 9d 4h]
Dealt to Cassandra O [9s 7c 8c 5s]
Curtis B: folds
Cassandra O: raises €0.50 to €0.70
Brad A: calls €0.60
MiamiBlues: calls €0.50
*** FLOP *** [Kh Ts 7d]
Brad A: checks
MiamiBlues: checks
Cassandra O: checks
*** TURN *** [Kh Ts 7d] [4d]
Brad A: checks
MiamiBlues: checks
Cassandra O: checks
*** RIVER *** [Kh Ts 7d 4d] [2d]
Brad A: checks
MiamiBlues: bets €1.01
Cassandra O: folds
Brad A: folds
MiamiBlues: mucks hand
*** SHOWDOWN ***
MiamiBlues: mucks hand
Uncalled bet (€1.01) returned to MiamiBlues
MiamiBlues collected €2.01 from pot
*** SUMMARY ***
Total pot €2.10 | Main pot €2.10 | Side pot €0.00 | Rake €0.09
Board [Kh Ts 7d 4d 2d]
Seat 4: Curtis B folded before Flop
Seat 6: Cassandra O (button) folded during River
Seat 2: Brad A (small blind) folded during River
Seat 3: MiamiBlues (big blind) mucked hand and won €2.01


**** **** **** **** **** **** **** ****


Run It Once Poker Hand #45241824:  Omaha Pot Limit (€0.10/€0.20) - 2020/05/24 18:20 UTC [2020/05/24 19:20 CET]
Table ID '45238934' 6-Max Seat #2 is the button
Seat 2: Brad A (€55.79 in chips)
Seat 3: MiamiBlues (€24.20 in chips)
Seat 4: Curtis B (€53.66 in chips)
Seat 6: Cassandra O (€20.63 in chips)
MiamiBlues: posts small blind €0.10
Curtis B: posts big blind €0.20
*** HOLE CARDS ***
Dealt to MiamiBlues [2s 9h Jh Tc]
Dealt to Curtis B [Kh 6c As 2d]
Dealt to Cassandra O [7h 4d 9s 6h]
Dealt to Brad A [Kc 4h Ts 8c]
Cassandra O: folds
Brad A: folds
MiamiBlues: raises €0.40 to €0.60
Curtis B: folds
*** SHOWDOWN ***
MiamiBlues: mucks hand
Uncalled bet (€0.40) returned to MiamiBlues
MiamiBlues collected €0.40 from pot
*** SUMMARY ***
Total pot €0.40 | Main pot €0.40 | Side pot €0.00 | Rake €0.00
Seat 6: Cassandra O folded before Flop
Seat 2: Brad A (button) folded before Flop
Seat 4: Curtis B (big blind) folded before Flop
Seat 3: MiamiBlues (small blind) mucked hand and won €0.40


**** **** **** **** **** **** **** ****


Run It Once Poker Hand #45241829:  Omaha Pot Limit (€0.10/€0.20) - 2020/05/24 18:20 UTC [2020/05/24 19:20 CET]
Table ID '45238934' 6-Max Seat #3 is the button
Seat 2: Brad A (€55.79 in chips)
Seat 3: MiamiBlues (€24.40 in chips)
Seat 4: Curtis B (€53.46 in chips)
Seat 5: Charles A (€29.13 in chips)
Seat 6: Cassandra O (€20.63 in chips)
Curtis B: posts small blind €0.10
Charles A: posts big blind €0.20
*** HOLE CARDS ***
Dealt to Curtis B [7d Qc 3s 2h]
Dealt to Charles A [Jc As 5s Kh]
Dealt to Cassandra O [9d 3c 4d 7h]
Dealt to Brad A [9c Jh 7c Qs]
Dealt to MiamiBlues [Js 3d 2c 4s]
Cassandra O: folds
Brad A: folds
MiamiBlues: raises €0.50 to €0.70
Curtis B: folds
Charles A: raises €1.50 to €2.20
MiamiBlues: calls €1.50
*** FLOP *** [3h Ks Kd]
Charles A: bets €1.08
MiamiBlues: folds
Charles A: mucks hand
*** SHOWDOWN ***
Charles A: mucks hand
Uncalled bet (€1.08) returned to Charles A
Charles A collected €4.30 from pot
*** SUMMARY ***
Total pot €4.50 | Main pot €4.50 | Side pot €0.00 | Rake €0.20
Board [3h Ks Kd]
Seat 6: Cassandra O folded before Flop
Seat 2: Brad A folded before Flop
Seat 4: Curtis B (small blind) folded before Flop
Seat 3: MiamiBlues (button) folded before Turn
Seat 5: Charles A (big blind) mucked hand and won €4.30


**** **** **** **** **** **** **** ****


Run It Once Poker Hand #45241840:  Omaha Pot Limit (€0.10/€0.20) - 2020/05/24 18:20 UTC [2020/05/24 19:20 CET]
Table ID '45238934' 6-Max Seat #4 is the button
Seat 2: Brad A (€55.79 in chips)
Seat 3: MiamiBlues (€22.20 in chips)
Seat 4: Curtis B (€53.36 in chips)
Seat 5: Charles A (€31.23 in chips)
Seat 6: Cassandra O (€20.63 in chips)
Charles A: posts small blind €0.10
Cassandra O: posts big blind €0.20
*** HOLE CARDS ***
Dealt to Charles A [Qd 2h 9s Ac]
Dealt to Cassandra O [2d 9c 9d Ah]
Dealt to Brad A [Tc Jd 6s 5c]
Dealt to MiamiBlues [3h Qc 5d 9h]
Dealt to Curtis B [As 6h 5h Kd]
Brad A: folds
MiamiBlues: folds
Curtis B: raises €0.50 to €0.70
Charles A: folds
Cassandra O: folds
*** SHOWDOWN ***
Curtis B: mucks hand
Uncalled bet (€0.50) returned to Curtis B
Curtis B collected €0.50 from pot
*** SUMMARY ***
Total pot €0.50 | Main pot €0.50 | Side pot €0.00 | Rake €0.00
Seat 2: Brad A folded before Flop
Seat 3: MiamiBlues folded before Flop
Seat 5: Charles A (small blind) folded before Flop
Seat 6: Cassandra O (big blind) folded before Flop
Seat 4: Curtis B (button) mucked hand and won €0.50


**** **** **** **** **** **** **** ****


Run It Once Poker Hand #45241843:  Omaha Pot Limit (€0.10/€0.20) - 2020/05/24 18:21 UTC [2020/05/24 19:21 CET]
Table ID '45238934' 6-Max Seat #5 is the button
Seat 1: Avery I (€30.54 in chips)
Seat 2: Brad A (€55.79 in chips)
Seat 3: MiamiBlues (€22.20 in chips)
Seat 4: Curtis B (€53.66 in chips)
Seat 5: Charles A (€31.13 in chips)
Seat 6: Cassandra O (€20.43 in chips)
Cassandra O: posts small blind €0.10
Avery I: posts big blind €0.20
*** HOLE CARDS ***
Dealt to Cassandra O [9h Qd 7s 3h]
Dealt to Avery I [Ad 6h Th 4s]
Dealt to Brad A [7d 2c 4c 3c]
Dealt to MiamiBlues [Ac Ts Jh 8s]
Dealt to Curtis B [8d 6c 5h 4h]
Dealt to Charles A [Td 3s Js Jd]
Brad A: folds
MiamiBlues: raises €0.50 to €0.70
Curtis B: folds
Charles A: calls €0.70
Cassandra O: folds
Avery I: folds
*** FLOP *** [6d 2d Kc]
MiamiBlues: checks
Charles A: checks
*** TURN *** [6d 2d Kc] [Qh]
MiamiBlues: bets €1.30
Charles A: calls €1.30
*** RIVER *** [6d 2d Kc Qh] [9s]
MiamiBlues: bets €3.29
Charles A: raises €10.69 to €13.98
MiamiBlues: calls €10.69
*** SHOWDOWN ***
MiamiBlues shows [Ac Ts Jh 8s] for Straight [Kc Qh Jh Ts 9s]
Charles A shows [Td 3s Js Jd] for Straight [Kc Qh Js Td 9s]
MiamiBlues collected €15.41 from pot
Charles A collected €15.40 from pot
*** SUMMARY ***
Total pot €32.26 | Main pot €32.26 | Side pot €0.00 | Rake €1.45
Board [6d 2d Kc Qh 9s]
Seat 2: Brad A folded before Flop
Seat 4: Curtis B folded before Flop
Seat 6: Cassandra O (small blind) folded before Flop
Seat 1: Avery I (big blind) folded before Flop
Seat 3: MiamiBlues showed [Ac Ts Jh 8s] and won €15.41 with Straight 9 to K
Seat 5: Charles A (button) showed [Td 3s Js Jd] and won €15.40 with Straight 9 to K


**** **** **** **** **** **** **** ****


Run It Once Poker Hand #45241854:  Omaha Pot Limit (€0.10/€0.20) - 2020/05/24 18:21 UTC [2020/05/24 19:21 CET]
Table ID '45238934' 6-Max Seat #6 is the button
Seat 1: Avery I (€30.34 in chips)
Seat 2: Brad A (€55.79 in chips)
Seat 3: MiamiBlues (€21.63 in chips)
Seat 4: Curtis B (€53.66 in chips)
Seat 5: Charles A (€30.55 in chips)
Seat 6: Cassandra O (€20.33 in chips)
Avery I: posts small blind €0.10
Brad A: posts big blind €0.20
*** HOLE CARDS ***
STP added: €0.20
Dealt to Avery I [Th 7c 2s Kd]
Dealt to Brad A [8s 5d Ks Tc]
Dealt to MiamiBlues [5s 5h 9d 9h]
Dealt to Curtis B [Ah Kh Ac 6s]
Dealt to Charles A [Qh 4c 7h Js]
Dealt to Cassandra O [6h 4d 3c 2h]
MiamiBlues: folds
Curtis B: raises €0.50 to €0.70
Charles A: folds
Cassandra O: folds
Avery I: folds
Brad A: folds
*** SHOWDOWN ***
Curtis B: mucks hand
Uncalled bet (€0.50) returned to Curtis B
Curtis B collected €0.70 from pot
*** SUMMARY ***
Total pot €0.70 | Main pot €0.50 | Side pot €0.00 | STP €0.20 | Rake €0.00
Seat 3: MiamiBlues folded before Flop
Seat 5: Charles A folded before Flop
Seat 6: Cassandra O (button) folded before Flop
Seat 1: Avery I (small blind) folded before Flop
Seat 2: Brad A (big blind) folded before Flop
Seat 4: Curtis B mucked hand and won €0.70


**** **** **** **** **** **** **** ****


Run It Once Poker Hand #45241859:  Omaha Pot Limit (€0.10/€0.20) - 2020/05/24 18:22 UTC [2020/05/24 19:22 CET]
Table ID '45238934' 6-Max Seat #1 is the button
Seat 1: Avery I (€30.24 in chips)
Seat 2: Brad A (€55.59 in chips)
Seat 3: MiamiBlues (€21.63 in chips)
Seat 4: Curtis B (€54.16 in chips)
Seat 5: Charles A (€30.55 in chips)
Seat 6: Cassandra O (€20.33 in chips)
Brad A: posts small blind €0.10
MiamiBlues: posts big blind €0.20
*** HOLE CARDS ***
Dealt to Brad A [7d Jc Qh 2s]
Dealt to MiamiBlues [4s 6c 9d Ac]
Dealt to Curtis B [Kc Kd 5h Th]
Dealt to Charles A [Ad 4c 8c 2c]
Dealt to Cassandra O [9c 4d 5d 2d]
Dealt to Avery I [7s 3c 5s 8s]
Curtis B: folds
Charles A: folds
Cassandra O: folds
Avery I: folds
Brad A: folds
*** SHOWDOWN ***
MiamiBlues: mucks hand
MiamiBlues collected €0.30 from pot
*** SUMMARY ***
Total pot €0.30 | Main pot €0.30 | Side pot €0.00 | Rake €0.00
Seat 4: Curtis B folded before Flop
Seat 5: Charles A folded before Flop
Seat 6: Cassandra O folded before Flop
Seat 1: Avery I (button) folded before Flop
Seat 2: Brad A (small blind) folded before Flop
Seat 3: MiamiBlues (big blind) mucked hand and won €0.30


**** **** **** **** **** **** **** ****


Run It Once Poker Hand #45241863:  Omaha Pot Limit (€0.10/€0.20) - 2020/05/24 18:22 UTC [2020/05/24 19:22 CET]
Table ID '45238934' 6-Max Seat #2 is the button
Seat 1: Avery I (€30.24 in chips)
Seat 2: Brad A (€55.49 in chips)
Seat 3: MiamiBlues (€21.73 in chips)
Seat 4: Curtis B (€54.16 in chips)
Seat 5: Charles A (€30.55 in chips)
Seat 6: Cassandra O (€20.33 in chips)
MiamiBlues: posts small blind €0.10
Curtis B: posts big blind €0.20
*** HOLE CARDS ***
Dealt to MiamiBlues [Th 6d 5d Js]
Dealt to Curtis B [Qc Jc Td 9c]
Dealt to Charles A [5h 2c 4h 9s]
Dealt to Cassandra O [3s 6c Tc 7s]
Dealt to Avery I [5c Kc 7h Jd]
Dealt to Brad A [Qd 8c Qs Ac]
Charles A: folds
Cassandra O: folds
Avery I: folds
Brad A: raises €0.50 to €0.70
MiamiBlues: folds
Curtis B: calls €0.50
*** FLOP *** [Qh 7c 2d]
Curtis B: checks
Brad A: bets €0.80
Curtis B: calls €0.80
*** TURN *** [Qh 7c 2d] [2s]
Curtis B: checks
Brad A: bets €1.48
Curtis B: folds
Brad A: mucks hand
*** SHOWDOWN ***
Brad A: mucks hand
Uncalled bet (€1.48) returned to Brad A
Brad A collected €2.96 from pot
*** SUMMARY ***
Total pot €3.10 | Main pot €3.10 | Side pot €0.00 | Rake €0.14
Board [Qh 7c 2d 2s]
Seat 5: Charles A folded before Flop
Seat 6: Cassandra O folded before Flop
Seat 1: Avery I folded before Flop
Seat 3: MiamiBlues (small blind) folded before Flop
Seat 4: Curtis B (big blind) folded before River
Seat 2: Brad A (button) mucked hand and won €2.96


**** **** **** **** **** **** **** ****


Run It Once Poker Hand #45241875:  Omaha Pot Limit (€0.10/€0.20) - 2020/05/24 18:23 UTC [2020/05/24 19:23 CET]
Table ID '45238934' 6-Max Seat #3 is the button
Seat 1: Avery I (€30.24 in chips)
Seat 2: Brad A (€56.95 in chips)
Seat 3: MiamiBlues (€21.63 in chips)
Seat 4: Curtis B (€52.66 in chips)
Seat 5: Charles A (€30.55 in chips)
Seat 6: Cassandra O (€20.33 in chips)
Curtis B: posts small blind €0.10
Charles A: posts big blind €0.20
*** HOLE CARDS ***
STP added: €0.40
Dealt to Curtis B [Kc Jc 9h 2s]
Dealt to Charles A [Th 3h 6c Qh]
Dealt to Cassandra O [9s 6s 4c 5h]
Dealt to Avery I [Qs Ad 9c Js]
Dealt to Brad A [Jh 5d Qd Qc]
Dealt to MiamiBlues [Kh 4h Ah 6d]
Cassandra O: folds
Avery I: raises €0.50 to €0.70
Brad A: calls €0.70
MiamiBlues: folds
Curtis B: folds
Charles A: folds
*** FLOP *** [Ts 8d 5c]
Avery I: bets €1.20
Brad A: calls €1.20
*** TURN *** [Ts 8d 5c] [5s]
Avery I: bets €2.80
Brad A: calls €2.80
*** RIVER *** [Ts 8d 5c 5s] [Tc]
Avery I: bets €5
Brad A: calls €5
*** SHOWDOWN ***
Brad A shows [Jh 5d Qd Qc] for Three of Kind [Qd Ts 5s 5d 5c]
Brad A collected €19.21 from pot
*** SUMMARY ***
Total pot €20.10 | Main pot €19.70 | Side pot €0.00 | STP €0.40 | Rake €0.89
Board [Ts 8d 5c 5s Tc]
Seat 6: Cassandra O folded before Flop
Seat 3: MiamiBlues (button) folded before Flop
Seat 4: Curtis B (small blind) folded before Flop
Seat 5: Charles A (big blind) folded before Flop
Seat 2: Brad A showed [Jh 5d Qd Qc] and won €19.21 with Three of Kind 5's and Q T
Seat 1: Avery I mucked [Qs Ad 9c Js] and lost


**** **** **** **** **** **** **** ****


Run It Once Poker Hand #45241888:  Omaha Pot Limit (€0.10/€0.20) - 2020/05/24 18:24 UTC [2020/05/24 19:24 CET]
Table ID '45238934' 6-Max Seat #4 is the button
Seat 1: Avery I (€20.54 in chips)
Seat 2: Brad A (€66.46 in chips)
Seat 3: MiamiBlues (€21.63 in chips)
Seat 4: Curtis B (€52.56 in chips)
Seat 5: Charles A (€30.35 in chips)
Seat 6: Cassandra O (€20.33 in chips)
Charles A: posts small blind €0.10
Cassandra O: posts big blind €0.20
*** HOLE CARDS ***
STP added: €0.20
Dealt to Charles A [Td 7s 3d 8h]
Dealt to Cassandra O [5h 4c Kc Kh]
Dealt to Avery I [3c 6c 5c Jc]
Dealt to Brad A [Ac Ks 7c 9d]
Dealt to MiamiBlues [4h 2s Ad 6d]
Dealt to Curtis B [Ts 8s 2h 6h]
Avery I: folds
Brad A: raises €0.50 to €0.70
MiamiBlues: folds
Curtis B: folds
Charles A: folds
Cassandra O: raises €1.50 to €2.20
Brad A: calls €1.50
*** FLOP *** [7h 9c 9s]
Cassandra O: checks
Brad A: bets €2.25
Cassandra O: calls €2.25
*** TURN *** [7h 9c 9s] [5s]
Cassandra O: checks
Brad A: bets €2.60
Cassandra O: calls €2.60
*** RIVER *** [7h 9c 9s 5s] [8d]
Cassandra O: checks
Brad A: bets €13.56
Cassandra O: folds
Brad A: mucks hand
*** SHOWDOWN ***
Brad A: mucks hand
Uncalled bet (€13.56) returned to Brad A
Brad A collected €13.76 from pot
*** SUMMARY ***
Total pot €14.40 | Main pot €14.20 | Side pot €0.00 | STP €0.20 | Rake €0.64
Board [7h 9c 9s 5s 8d]
Seat 1: Avery I folded before Flop
Seat 3: MiamiBlues folded before Flop
Seat 4: Curtis B (button) folded before Flop
Seat 5: Charles A (small blind) folded before Flop
Seat 6: Cassandra O (big blind) folded during River
Seat 2: Brad A mucked hand and won €13.76


**** **** **** **** **** **** **** ****


Run It Once Poker Hand #45241906:  Omaha Pot Limit (€0.10/€0.20) - 2020/05/24 18:25 UTC [2020/05/24 19:25 CET]
Table ID '45238934' 6-Max Seat #5 is the button
Seat 1: Avery I (€20.54 in chips)
Seat 2: Brad A (€73.17 in chips)
Seat 3: MiamiBlues (€21.63 in chips)
Seat 4: Curtis B (€52.56 in chips)
Seat 5: Charles A (€30.25 in chips)
Seat 6: Cassandra O (€20 in chips)
Cassandra O: posts small blind €0.10
Avery I: posts big blind €0.20
*** HOLE CARDS ***
Dealt to Cassandra O [6c Ah Kh Tc]
Dealt to Avery I [Ad 8s Kd Ts]
Dealt to Brad A [Qs 5c 4d 7s]
Dealt to MiamiBlues [8h Jh 8d As]
Dealt to Curtis B [Th Jc 3d 6h]
Dealt to Charles A [Kc 9h 2d 2h]
Brad A: folds
MiamiBlues: folds
Curtis B: folds
Charles A: folds
Cassandra O: raises €0.40 to €0.60
Avery I: raises €1.20 to €1.80
Cassandra O: calls €1.20
*** FLOP *** [2c 6d 5d]
Cassandra O: checks
Avery I: bets €1.72
Cassandra O: calls €1.72
*** TURN *** [2c 6d 5d] [7d]
Cassandra O: checks
Avery I: bets €4
Cassandra O: folds
Avery I: mucks hand
*** SHOWDOWN ***
Avery I: mucks hand
Uncalled bet (€4) returned to Avery I
Avery I collected €6.72 from pot
*** SUMMARY ***
Total pot €7.04 | Main pot €7.04 | Side pot €0.00 | Rake €0.32
Board [2c 6d 5d 7d]
Seat 2: Brad A folded before Flop
Seat 3: MiamiBlues folded before Flop
Seat 4: Curtis B folded before Flop
Seat 5: Charles A (button) folded before Flop
Seat 6: Cassandra O (small blind) folded before River
Seat 1: Avery I (big blind) mucked hand and won €6.72


**** **** **** **** **** **** **** ****


Run It Once Poker Hand #45241921:  Omaha Pot Limit (€0.10/€0.20) - 2020/05/24 18:26 UTC [2020/05/24 19:26 CET]
Table ID '45238934' 6-Max Seat #6 is the button
Seat 1: Avery I (€23.74 in chips)
Seat 2: Brandon C (€20 in chips)
Seat 3: MiamiBlues (€21.63 in chips)
Seat 4: Curtis B (€52.56 in chips)
Seat 5: Charles A (€30.25 in chips)
Seat 6: Cassandra O (€20 in chips)
Avery I: posts small blind €0.10
Brandon C: posts big blind €0.20
*** HOLE CARDS ***
Dealt to Avery I [Qd Ks Kc 2d]
Dealt to Brandon C [5h 3s 9c Tc]
Dealt to MiamiBlues [As 5s 6c 8s]
Dealt to Curtis B [8c Jh 4d 2s]
Dealt to Charles A [Jc 7s 8h Ac]
Dealt to Cassandra O [7d 4s Ts 9s]
MiamiBlues: folds
Curtis B: folds
Charles A: raises €0.50 to €0.70
Cassandra O: folds
Avery I: folds
Brandon C: folds
*** SHOWDOWN ***
Charles A: mucks hand
Uncalled bet (€0.50) returned to Charles A
Charles A collected €0.50 from pot
*** SUMMARY ***
Total pot €0.50 | Main pot €0.50 | Side pot €0.00 | Rake €0.00
Seat 3: MiamiBlues folded before Flop
Seat 4: Curtis B folded before Flop
Seat 6: Cassandra O (button) folded before Flop
Seat 1: Avery I (small blind) folded before Flop
Seat 2: Brandon C (big blind) folded before Flop
Seat 5: Charles A mucked hand and won €0.50


**** **** **** **** **** **** **** ****


Run It Once Poker Hand #45241927:  Omaha Pot Limit (€0.10/€0.20) - 2020/05/24 18:26 UTC [2020/05/24 19:26 CET]
Table ID '45238934' 6-Max Seat #1 is the button
Seat 1: Avery I (€23.64 in chips)
Seat 2: Brandon C (€20 in chips)
Seat 3: MiamiBlues (€21.63 in chips)
Seat 4: Curtis B (€52.56 in chips)
Seat 5: Charles A (€30.55 in chips)
Seat 6: Cassandra O (€20 in chips)
Brandon C: posts small blind €0.10
MiamiBlues: posts big blind €0.20
*** HOLE CARDS ***
Dealt to Brandon C [2s 4s Jh Js]
Dealt to MiamiBlues [8d 6d 6s Kc]
Dealt to Curtis B [Tc Qd 4h Kh]
Dealt to Charles A [Qh 9c 9s 7c]
Dealt to Cassandra O [Ks 5d 9d 5c]
Dealt to Avery I [Qc Jc 2d 7d]
Curtis B: folds
Charles A: folds
Cassandra O: folds
Avery I: raises €0.50 to €0.70
Brandon C: folds
MiamiBlues: folds
*** SHOWDOWN ***
Avery I: mucks hand
Uncalled bet (€0.50) returned to Avery I
Avery I collected €0.50 from pot
*** SUMMARY ***
Total pot €0.50 | Main pot €0.50 | Side pot €0.00 | Rake €0.00
Seat 4: Curtis B folded before Flop
Seat 5: Charles A folded before Flop
Seat 6: Cassandra O folded before Flop
Seat 2: Brandon C (small blind) folded before Flop
Seat 3: MiamiBlues (big blind) folded before Flop
Seat 1: Avery I (button) mucked hand and won €0.50


**** **** **** **** **** **** **** ****


Run It Once Poker Hand #45241930:  Omaha Pot Limit (€0.10/€0.20) - 2020/05/24 18:27 UTC [2020/05/24 19:27 CET]
Table ID '45238934' 6-Max Seat #2 is the button
Seat 1: Avery I (€23.94 in chips)
Seat 2: Brandon C (€20 in chips)
Seat 3: MiamiBlues (€21.43 in chips)
Seat 4: Curtis B (€52.56 in chips)
Seat 5: Charles A (€30.55 in chips)
Seat 6: Cassandra O (€20 in chips)
MiamiBlues: posts small blind €0.10
Curtis B: posts big blind €0.20
*** HOLE CARDS ***
Dealt to MiamiBlues [2h 2c 6s 9c]
Dealt to Curtis B [Qc 4d Qd Qs]
Dealt to Charles A [8s 5s Jc Js]
Dealt to Cassandra O [4s 7d 3s 8h]
Dealt to Avery I [Ks 5h 2d 9h]
Dealt to Brandon C [2s 3c 8d 8c]
Charles A: raises €0.40 to €0.60
Cassandra O: folds
Avery I: folds
Brandon C: folds
MiamiBlues: folds
Curtis B: folds
*** SHOWDOWN ***
Charles A: mucks hand
Uncalled bet (€0.40) returned to Charles A
Charles A collected €0.50 from pot
*** SUMMARY ***
Total pot €0.50 | Main pot €0.50 | Side pot €0.00 | Rake €0.00
Seat 6: Cassandra O folded before Flop
Seat 1: Avery I folded before Flop
Seat 2: Brandon C (button) folded before Flop
Seat 3: MiamiBlues (small blind) folded before Flop
Seat 4: Curtis B (big blind) folded before Flop
Seat 5: Charles A mucked hand and won €0.50


**** **** **** **** **** **** **** ****


Run It Once Poker Hand #45241934:  Omaha Pot Limit (€0.10/€0.20) - 2020/05/24 18:27 UTC [2020/05/24 19:27 CET]
Table ID '45238934' 6-Max Seat #3 is the button
Seat 1: Avery I (€23.94 in chips)
Seat 2: Brandon C (€20 in chips)
Seat 3: MiamiBlues (€21.33 in chips)
Seat 4: Curtis B (€52.36 in chips)
Seat 5: Charles A (€30.85 in chips)
Seat 6: Cassandra O (€20 in chips)
Curtis B: posts small blind €0.10
Charles A: posts big blind €0.20
*** HOLE CARDS ***
Dealt to Curtis B [7s 7c Jh 6s]
Dealt to Charles A [9c 3s Jc Kc]
Dealt to Cassandra O [Td 2d 9d Kh]
Dealt to Avery I [Qh 7h 5c Qs]
Dealt to Brandon C [6c 2s 5h 5s]
Dealt to MiamiBlues [Ac 3d 4d 8c]
Cassandra O: folds
Avery I: folds
Brandon C: folds
MiamiBlues: raises €0.50 to €0.70
Curtis B: folds
Charles A: calls €0.50
*** FLOP *** [7d Tc Ks]
Charles A: checks
MiamiBlues: bets €0.50
Charles A: calls €0.50
*** TURN *** [7d Tc Ks] [Th]
Charles A: checks
MiamiBlues: checks
*** RIVER *** [7d Tc Ks Th] [2h]
Charles A: checks
MiamiBlues: checks
*** SHOWDOWN ***
Charles A shows [9c 3s Jc Kc] for Two Pairs [Ks Kc Jc Th Tc]
Charles A collected €2.39 from pot
*** SUMMARY ***
Total pot €2.50 | Main pot €2.50 | Side pot €0.00 | Rake €0.11
Board [7d Tc Ks Th 2h]
Seat 6: Cassandra O folded before Flop
Seat 1: Avery I folded before Flop
Seat 2: Brandon C folded before Flop
Seat 4: Curtis B (small blind) folded before Flop
Seat 5: Charles A (big blind) showed [9c 3s Jc Kc] and won €2.39 with Two Pairs K T and J
Seat 3: MiamiBlues (button) mucked [Ac 3d 4d 8c] and lost


**** **** **** **** **** **** **** ****


Run It Once Poker Hand #45241945:  Omaha Pot Limit (€0.10/€0.20) - 2020/05/24 18:28 UTC [2020/05/24 19:28 CET]
Table ID '45238934' 6-Max Seat #4 is the button
Seat 1: Avery I (€23.94 in chips)
Seat 2: Brandon C (€20 in chips)
Seat 3: MiamiBlues (€20.13 in chips)
Seat 4: Curtis B (€52.26 in chips)
Seat 5: Charles A (€32.04 in chips)
Seat 6: Cassandra O (€20 in chips)
Charles A: posts small blind €0.10
Cassandra O: posts big blind €0.20
*** HOLE CARDS ***
Dealt to Charles A [6s Kc As 5s]
Dealt to Cassandra O [Js Jd Jc Ks]
Dealt to Avery I [Qd Ah 4s 3h]
Dealt to Brandon C [4c 5h 3d 8c]
Dealt to MiamiBlues [3s 4h 7h 4d]
Dealt to Curtis B [Qc Tc 2d Kd]
Avery I: folds
Brandon C: folds
MiamiBlues: folds
Curtis B: raises €0.50 to €0.70
Charles A: raises €1.60 to €2.30
Cassandra O: folds
Curtis B: calls €1.60
*** FLOP *** [9h 9s Jh]
Charles A: bets €1.15
Curtis B: calls €1.15
*** TURN *** [9h 9s Jh] [6d]
Charles A: checks
Curtis B: checks
*** RIVER *** [9h 9s Jh 6d] [6c]
Charles A: bets €3.40
Curtis B: folds
Charles A: mucks hand
*** SHOWDOWN ***
Charles A: mucks hand
Uncalled bet (€3.40) returned to Charles A
Charles A collected €6.78 from pot
*** SUMMARY ***
Total pot €7.10 | Main pot €7.10 | Side pot €0.00 | Rake €0.32
Board [9h 9s Jh 6d 6c]
Seat 1: Avery I folded before Flop
Seat 2: Brandon C folded before Flop
Seat 3: MiamiBlues folded before Flop
Seat 6: Cassandra O (big blind) folded before Flop
Seat 4: Curtis B (button) folded during River
Seat 5: Charles A (small blind) mucked hand and won €6.78


**** **** **** **** **** **** **** ****


Run It Once Poker Hand #45241961:  Omaha Pot Limit (€0.10/€0.20) - 2020/05/24 18:29 UTC [2020/05/24 19:29 CET]
Table ID '45238934' 6-Max Seat #5 is the button
Seat 1: Avery I (€23.94 in chips)
Seat 2: Brandon C (€20 in chips)
Seat 3: MiamiBlues (€20.13 in chips)
Seat 4: Curtis B (€48.81 in chips)
Seat 5: Charles A (€35.37 in chips)
Seat 6: Cassandra O (€20 in chips)
Cassandra O: posts small blind €0.10
Avery I: posts big blind €0.20
*** HOLE CARDS ***
Dealt to Cassandra O [3s 7s 8h Ah]
Dealt to Avery I [Ad 8s 5c Jh]
Dealt to Brandon C [9s 6h 8d Ks]
Dealt to MiamiBlues [3c Js Kc 4h]
Dealt to Curtis B [7d 2c 7c 4c]
Dealt to Charles A [Qh Td Tc 6d]
Brandon C: folds
MiamiBlues: folds
Curtis B: folds
Charles A: folds
Cassandra O: raises €0.40 to €0.60
Avery I: calls €0.40
*** FLOP *** [Ts Th As]
Cassandra O: checks
Avery I: checks
*** TURN *** [Ts Th As] [9d]
Cassandra O: bets €0.86
Avery I: folds
Cassandra O: mucks hand
*** SHOWDOWN ***
Cassandra O: mucks hand
Uncalled bet (€0.86) returned to Cassandra O
Cassandra O collected €1.15 from pot
*** SUMMARY ***
Total pot €1.20 | Main pot €1.20 | Side pot €0.00 | Rake €0.05
Board [Ts Th As 9d]
Seat 2: Brandon C folded before Flop
Seat 3: MiamiBlues folded before Flop
Seat 4: Curtis B folded before Flop
Seat 5: Charles A (button) folded before Flop
Seat 1: Avery I (big blind) folded before River
Seat 6: Cassandra O (small blind) mucked hand and won €1.15


**** **** **** **** **** **** **** ****


Run It Once Poker Hand #45241967:  Omaha Pot Limit (€0.10/€0.20) - 2020/05/24 18:30 UTC [2020/05/24 19:30 CET]
Table ID '45238934' 6-Max Seat #6 is the button
Seat 1: Avery I (€23.34 in chips)
Seat 2: Brandon C (€20 in chips)
Seat 3: MiamiBlues (€20.13 in chips)
Seat 4: Curtis B (€48.81 in chips)
Seat 5: Charles A (€35.37 in chips)
Seat 6: Cassandra O (€20.55 in chips)
Avery I: posts small blind €0.10
Brandon C: posts big blind €0.20
*** HOLE CARDS ***
Dealt to Avery I [Qd 2d 3s As]
Dealt to Brandon C [3d 8h Ah Jc]
Dealt to MiamiBlues [2s Ks 2c 5c]
Dealt to Curtis B [8c 9h 7h 7d]
Dealt to Charles A [Jh 9s 5h 4c]
Dealt to Cassandra O [Td 4s 6s Ts]
MiamiBlues: folds
Curtis B: raises €0.50 to €0.70
Charles A: folds
Cassandra O: folds
Avery I: raises €1.60 to €2.30
Brandon C: folds
Curtis B: calls €1.60
*** FLOP *** [4h Js 3c]
Avery I: bets €1.80
Curtis B: folds
Avery I: mucks hand
*** SHOWDOWN ***
Avery I: mucks hand
Uncalled bet (€1.80) returned to Avery I
Avery I collected €4.58 from pot
*** SUMMARY ***
Total pot €4.80 | Main pot €4.80 | Side pot €0.00 | Rake €0.22
Board [4h Js 3c]
Seat 3: MiamiBlues folded before Flop
Seat 5: Charles A folded before Flop
Seat 6: Cassandra O (button) folded before Flop
Seat 2: Brandon C (big blind) folded before Flop
Seat 4: Curtis B folded before Turn
Seat 1: Avery I (small blind) mucked hand and won €4.58


**** **** **** **** **** **** **** ****


Run It Once Poker Hand #45241981:  Omaha Pot Limit (€0.10/€0.20) - 2020/05/24 18:30 UTC [2020/05/24 19:30 CET]
Table ID '45238934' 6-Max Seat #1 is the button
Seat 1: Avery I (€25.62 in chips)
Seat 2: Brandon C (€20 in chips)
Seat 3: MiamiBlues (€20.13 in chips)
Seat 4: Curtis B (€46.51 in chips)
Seat 5: Charles A (€35.37 in chips)
Seat 6: Cassandra O (€20.55 in chips)
Brandon C: posts small blind €0.10
MiamiBlues: posts big blind €0.20
*** HOLE CARDS ***
Dealt to Brandon C [2d Ts Td 8c]
Dealt to MiamiBlues [2s As 9s Kc]
Dealt to Curtis B [Ac Qs Kh 3h]
Dealt to Charles A [Th 8h 7s 6c]
Dealt to Cassandra O [Qh 9d 7h 3c]
Dealt to Avery I [5s 5c 3s Jh]
Curtis B: folds
Charles A: raises €0.40 to €0.60
Cassandra O: folds
Avery I: folds
Brandon C: folds
MiamiBlues: folds
*** SHOWDOWN ***
Charles A: mucks hand
Uncalled bet (€0.40) returned to Charles A
Charles A collected €0.50 from pot
*** SUMMARY ***
Total pot €0.50 | Main pot €0.50 | Side pot €0.00 | Rake €0.00
Seat 4: Curtis B folded before Flop
Seat 6: Cassandra O folded before Flop
Seat 1: Avery I (button) folded before Flop
Seat 2: Brandon C (small blind) folded before Flop
Seat 3: MiamiBlues (big blind) folded before Flop
Seat 5: Charles A mucked hand and won €0.50


**** **** **** **** **** **** **** ****


Run It Once Poker Hand #45241984:  Omaha Pot Limit (€0.10/€0.20) - 2020/05/24 18:31 UTC [2020/05/24 19:31 CET]
Table ID '45238934' 6-Max Seat #2 is the button
Seat 1: Avery I (€25.62 in chips)
Seat 2: Brandon C (€20 in chips)
Seat 3: MiamiBlues (€20 in chips)
Seat 4: Curtis B (€46.51 in chips)
Seat 5: Charles A (€35.67 in chips)
Seat 6: Cassandra O (€20.55 in chips)
MiamiBlues: posts small blind €0.10
Curtis B: posts big blind €0.20
*** HOLE CARDS ***
Dealt to MiamiBlues [8d Ks 3h 3d]
Dealt to Curtis B [8c 2s 6s As]
Dealt to Charles A [Kc 3c 4h Jh]
Dealt to Cassandra O [Kd 7h 5s 9c]
Dealt to Avery I [2c 7d Js Td]
Dealt to Brandon C [6d 4d 9d Qs]
Charles A: raises €0.40 to €0.60
Cassandra O: folds
Avery I: folds
Brandon C: folds
MiamiBlues: folds
Curtis B: folds
*** SHOWDOWN ***
Charles A: mucks hand
Uncalled bet (€0.40) returned to Charles A
Charles A collected €0.50 from pot
*** SUMMARY ***
Total pot €0.50 | Main pot €0.50 | Side pot €0.00 | Rake €0.00
Seat 6: Cassandra O folded before Flop
Seat 1: Avery I folded before Flop
Seat 2: Brandon C (button) folded before Flop
Seat 3: MiamiBlues (small blind) folded before Flop
Seat 4: Curtis B (big blind) folded before Flop
Seat 5: Charles A mucked hand and won €0.50


**** **** **** **** **** **** **** ****


Run It Once Poker Hand #45241991:  Omaha Pot Limit (€0.10/€0.20) - 2020/05/24 18:31 UTC [2020/05/24 19:31 CET]
Table ID '45238934' 6-Max Seat #3 is the button
Seat 1: Avery I (€25.62 in chips)
Seat 2: Brandon C (€20 in chips)
Seat 3: MiamiBlues (€20 in chips)
Seat 4: Curtis B (€46.31 in chips)
Seat 5: Charles A (€35.97 in chips)
Seat 6: Cassandra O (€20.55 in chips)
Curtis B: posts small blind €0.10
Charles A: posts big blind €0.20
*** HOLE CARDS ***
Dealt to Curtis B [Ad Kc 8s 5d]
Dealt to Charles A [4c 2h 7s 8d]
Dealt to Cassandra O [9h Th 4h 9s]
Dealt to Avery I [4s 8c 6s Js]
Dealt to Brandon C [Qs 9c Ah 7c]
Dealt to MiamiBlues [As Ac 7h 2s]
Cassandra O: folds
Avery I: folds
Brandon C: folds
MiamiBlues: raises €0.50 to €0.70
Curtis B: folds
Charles A: folds
*** SHOWDOWN ***
MiamiBlues: mucks hand
Uncalled bet (€0.50) returned to MiamiBlues
MiamiBlues collected €0.50 from pot
*** SUMMARY ***
Total pot €0.50 | Main pot €0.50 | Side pot €0.00 | Rake €0.00
Seat 6: Cassandra O folded before Flop
Seat 1: Avery I folded before Flop
Seat 2: Brandon C folded before Flop
Seat 4: Curtis B (small blind) folded before Flop
Seat 5: Charles A (big blind) folded before Flop
Seat 3: MiamiBlues (button) mucked hand and won €0.50


**** **** **** **** **** **** **** ****


Run It Once Poker Hand #45241994:  Omaha Pot Limit (€0.10/€0.20) - 2020/05/24 18:31 UTC [2020/05/24 19:31 CET]
Table ID '45238934' 6-Max Seat #4 is the button
Seat 1: Avery I (€25.62 in chips)
Seat 2: Brandon C (€20 in chips)
Seat 3: MiamiBlues (€20.30 in chips)
Seat 4: Curtis B (€46.21 in chips)
Seat 5: Charles A (€35.77 in chips)
Seat 6: Cassandra O (€20.55 in chips)
Charles A: posts small blind €0.10
Cassandra O: posts big blind €0.20
*** HOLE CARDS ***
Dealt to Charles A [8d 7s Qh 3d]
Dealt to Cassandra O [Kd Ah Ts 3s]
Dealt to Avery I [5h 9c As Ac]
Dealt to Brandon C [Qd 6c Ad 2s]
Dealt to MiamiBlues [6h Th 6d Kc]
Dealt to Curtis B [7c 3c 7h Jc]
Avery I: raises €0.50 to €0.70
Brandon C: folds
MiamiBlues: folds
Curtis B: folds
Charles A: folds
Cassandra O: folds
*** SHOWDOWN ***
Avery I: mucks hand
Uncalled bet (€0.50) returned to Avery I
Avery I collected €0.50 from pot
*** SUMMARY ***
Total pot €0.50 | Main pot €0.50 | Side pot €0.00 | Rake €0.00
Seat 2: Brandon C folded before Flop
Seat 3: MiamiBlues folded before Flop
Seat 4: Curtis B (button) folded before Flop
Seat 5: Charles A (small blind) folded before Flop
Seat 6: Cassandra O (big blind) folded before Flop
Seat 1: Avery I mucked hand and won €0.50


**** **** **** **** **** **** **** ****


Run It Once Poker Hand #45241996:  Omaha Pot Limit (€0.10/€0.20) - 2020/05/24 18:32 UTC [2020/05/24 19:32 CET]
Table ID '45238934' 6-Max Seat #5 is the button
Seat 1: Avery I (€25.92 in chips)
Seat 2: Brandon C (€20 in chips)
Seat 3: MiamiBlues (€20.30 in chips)
Seat 4: Curtis B (€46.21 in chips)
Seat 5: Charles A (€35.67 in chips)
Seat 6: Cassandra O (€20.35 in chips)
Cassandra O: posts small blind €0.10
Avery I: posts big blind €0.20
*** HOLE CARDS ***
Dealt to Cassandra O [2c Jd 8s 4s]
Dealt to Avery I [Kc Kh 4h Th]
Dealt to Brandon C [6s 7h 4d 3c]
Dealt to MiamiBlues [Jh 3d Ks 8d]
Dealt to Curtis B [7c 8c Qh 9h]
Dealt to Charles A [9d 6h 8h Ah]
Brandon C: folds
MiamiBlues: folds
Curtis B: raises €0.50 to €0.70
Charles A: calls €0.70
Cassandra O: folds
Avery I: folds
*** FLOP *** [Js Ad 2s]
Curtis B: checks
Charles A: bets €1
Curtis B: folds
Charles A: mucks hand
*** SHOWDOWN ***
Charles A: mucks hand
Uncalled bet (€1) returned to Charles A
Charles A collected €1.62 from pot
*** SUMMARY ***
Total pot €1.70 | Main pot €1.70 | Side pot €0.00 | Rake €0.08
Board [Js Ad 2s]
Seat 2: Brandon C folded before Flop
Seat 3: MiamiBlues folded before Flop
Seat 6: Cassandra O (small blind) folded before Flop
Seat 1: Avery I (big blind) folded before Flop
Seat 4: Curtis B folded before Turn
Seat 5: Charles A (button) mucked hand and won €1.62


**** **** **** **** **** **** **** ****


Run It Once Poker Hand #45242008:  Omaha Pot Limit (€0.10/€0.20) - 2020/05/24 18:32 UTC [2020/05/24 19:32 CET]
Table ID '45238934' 6-Max Seat #6 is the button
Seat 1: Avery I (€25.72 in chips)
Seat 2: Brandon C (€20 in chips)
Seat 3: MiamiBlues (€20.30 in chips)
Seat 4: Curtis B (€45.51 in chips)
Seat 5: Charles A (€36.59 in chips)
Seat 6: Cassandra O (€20.25 in chips)
Avery I: posts small blind €0.10
Brandon C: posts big blind €0.20
*** HOLE CARDS ***
Dealt to Avery I [4c 7h 5d Jd]
Dealt to Brandon C [2s 7s 3d Jc]
Dealt to MiamiBlues [5s 4d Ks Kh]
Dealt to Curtis B [3h Qc 7d Ad]
Dealt to Charles A [Qs 5c Js 2d]
Dealt to Cassandra O [Kd 2c 7c 6s]
MiamiBlues: raises €0.50 to €0.70
Curtis B: folds
Charles A: folds
Cassandra O: folds
Avery I: folds
Brandon C: folds
*** SHOWDOWN ***
MiamiBlues: mucks hand
Uncalled bet (€0.50) returned to MiamiBlues
MiamiBlues collected €0.50 from pot
*** SUMMARY ***
Total pot €0.50 | Main pot €0.50 | Side pot €0.00 | Rake €0.00
Seat 4: Curtis B folded before Flop
Seat 5: Charles A folded before Flop
Seat 6: Cassandra O (button) folded before Flop
Seat 1: Avery I (small blind) folded before Flop
Seat 2: Brandon C (big blind) folded before Flop
Seat 3: MiamiBlues mucked hand and won €0.50


**** **** **** **** **** **** **** ****


Run It Once Poker Hand #45242010:  Omaha Pot Limit (€0.10/€0.20) - 2020/05/24 18:33 UTC [2020/05/24 19:33 CET]
Table ID '45238934' 6-Max Seat #1 is the button
Seat 1: Avery I (€25.62 in chips)
Seat 2: Brandon C (€20 in chips)
Seat 3: MiamiBlues (€20.60 in chips)
Seat 4: Curtis B (€45.51 in chips)
Seat 5: Charles A (€36.59 in chips)
Seat 6: Cassandra O (€20.25 in chips)
Brandon C: posts small blind €0.10
MiamiBlues: posts big blind €0.20
*** HOLE CARDS ***
Dealt to Brandon C [Ts 2c Ac 7c]
Dealt to MiamiBlues [Jc 5s Tc Td]
Dealt to Curtis B [2h 5c 5h Ad]
Dealt to Charles A [6s Ks 3d Kc]
Dealt to Cassandra O [4h Jh Qc 4d]
Dealt to Avery I [6c 2s 3s As]
Curtis B: folds
Charles A: raises €0.50 to €0.70
Cassandra O: folds
Avery I: folds
Brandon C: folds
MiamiBlues: folds
*** SHOWDOWN ***
Charles A: mucks hand
Uncalled bet (€0.50) returned to Charles A
Charles A collected €0.50 from pot
*** SUMMARY ***
Total pot €0.50 | Main pot €0.50 | Side pot €0.00 | Rake €0.00
Seat 4: Curtis B folded before Flop
Seat 6: Cassandra O folded before Flop
Seat 1: Avery I (button) folded before Flop
Seat 2: Brandon C (small blind) folded before Flop
Seat 3: MiamiBlues (big blind) folded before Flop
Seat 5: Charles A mucked hand and won €0.50


**** **** **** **** **** **** **** ****


Run It Once Poker Hand #45242017:  Omaha Pot Limit (€0.10/€0.20) - 2020/05/24 18:33 UTC [2020/05/24 19:33 CET]
Table ID '45238934' 6-Max Seat #2 is the button
Seat 1: Avery I (€25.62 in chips)
Seat 2: Brandon C (€20 in chips)
Seat 3: MiamiBlues (€20.40 in chips)
Seat 4: Curtis B (€45.51 in chips)
Seat 5: Charles A (€36.89 in chips)
Seat 6: Cassandra O (€20.25 in chips)
MiamiBlues: posts small blind €0.10
Curtis B: posts big blind €0.20
*** HOLE CARDS ***
Dealt to MiamiBlues [Qs 3s 2s Kh]
Dealt to Curtis B [9c Ad 6c 3h]
Dealt to Charles A [5c 5h Qd 5d]
Dealt to Cassandra O [9h 2c 4c Jc]
Dealt to Avery I [4h Jh 8d 2d]
Dealt to Brandon C [Qh 4d As Js]
Charles A: folds
Cassandra O: folds
Avery I: folds
Brandon C: raises €0.50 to €0.70
MiamiBlues: folds
Curtis B: folds
*** SHOWDOWN ***
Brandon C: mucks hand
Uncalled bet (€0.50) returned to Brandon C
Brandon C collected €0.50 from pot
*** SUMMARY ***
Total pot €0.50 | Main pot €0.50 | Side pot €0.00 | Rake €0.00
Seat 5: Charles A folded before Flop
Seat 6: Cassandra O folded before Flop
Seat 1: Avery I folded before Flop
Seat 3: MiamiBlues (small blind) folded before Flop
Seat 4: Curtis B (big blind) folded before Flop
Seat 2: Brandon C (button) mucked hand and won €0.50


**** **** **** **** **** **** **** ****


Run It Once Poker Hand #45242023:  Omaha Pot Limit (€0.10/€0.20) - 2020/05/24 18:33 UTC [2020/05/24 19:33 CET]
Table ID '45238934' 6-Max Seat #3 is the button
Seat 1: Avery I (€25.62 in chips)
Seat 2: Brandon C (€20.30 in chips)
Seat 3: MiamiBlues (€20.30 in chips)
Seat 4: Curtis B (€45.31 in chips)
Seat 5: Charles A (€36.89 in chips)
Seat 6: Cassandra O (€20.25 in chips)
Curtis B: posts small blind €0.10
Charles A: posts big blind €0.20
*** HOLE CARDS ***
Dealt to Curtis B [Qh Ks Qd Jc]
Dealt to Charles A [7h 2h Ts 7d]
Dealt to Cassandra O [5c Ad Ac Th]
Dealt to Avery I [4s Js Kd Kc]
Dealt to Brandon C [9s 4c 3h 3c]
Dealt to MiamiBlues [2d 8d Qs 3d]
Cassandra O: raises €0.50 to €0.70
Avery I: folds
Brandon C: folds
MiamiBlues: folds
Curtis B: folds
Charles A: folds
*** SHOWDOWN ***
Cassandra O: mucks hand
Uncalled bet (€0.50) returned to Cassandra O
Cassandra O collected €0.50 from pot
*** SUMMARY ***
Total pot €0.50 | Main pot €0.50 | Side pot €0.00 | Rake €0.00
Seat 1: Avery I folded before Flop
Seat 2: Brandon C folded before Flop
Seat 3: MiamiBlues (button) folded before Flop
Seat 4: Curtis B (small blind) folded before Flop
Seat 5: Charles A (big blind) folded before Flop
Seat 6: Cassandra O mucked hand and won €0.50


**** **** **** **** **** **** **** ****


Run It Once Poker Hand #45242029:  Omaha Pot Limit (€0.10/€0.20) - 2020/05/24 18:34 UTC [2020/05/24 19:34 CET]
Table ID '45238934' 6-Max Seat #4 is the button
Seat 1: Avery I (€25.62 in chips)
Seat 2: Brandon C (€20.30 in chips)
Seat 3: MiamiBlues (€20.30 in chips)
Seat 4: Curtis B (€45.21 in chips)
Seat 5: Charles A (€36.69 in chips)
Seat 6: Cassandra O (€20.55 in chips)
Charles A: posts small blind €0.10
Cassandra O: posts big blind €0.20
*** HOLE CARDS ***
Dealt to Charles A [Jd Tc 6h 5c]
Dealt to Cassandra O [6s 4h 8s 4d]
Dealt to Avery I [Jc 9h 4c Ks]
Dealt to Brandon C [Ac Kd 8h 3d]
Dealt to MiamiBlues [6d 8d Ts Kh]
Dealt to Curtis B [Ah 3h Jh 9d]
Avery I: folds
Brandon C: folds
MiamiBlues: folds
Curtis B: folds
Charles A: folds
*** SHOWDOWN ***
Cassandra O: mucks hand
Cassandra O collected €0.30 from pot
*** SUMMARY ***
Total pot €0.30 | Main pot €0.30 | Side pot €0.00 | Rake €0.00
Seat 1: Avery I folded before Flop
Seat 2: Brandon C folded before Flop
Seat 3: MiamiBlues folded before Flop
Seat 4: Curtis B (button) folded before Flop
Seat 5: Charles A (small blind) folded before Flop
Seat 6: Cassandra O (big blind) mucked hand and won €0.30


**** **** **** **** **** **** **** ****


Run It Once Poker Hand #45242032:  Omaha Pot Limit (€0.10/€0.20) - 2020/05/24 18:34 UTC [2020/05/24 19:34 CET]
Table ID '45238934' 6-Max Seat #5 is the button
Seat 1: Avery I (€25.62 in chips)
Seat 2: Brandon C (€20.30 in chips)
Seat 3: MiamiBlues (€20.30 in chips)
Seat 4: Curtis B (€45.21 in chips)
Seat 5: Charles A (€36.59 in chips)
Seat 6: Cassandra O (€20.65 in chips)
Cassandra O: posts small blind €0.10
Avery I: posts big blind €0.20
*** HOLE CARDS ***
Dealt to Cassandra O [Ks Kh 2d 6c]
Dealt to Avery I [Ac 2h Qc 8c]
Dealt to Brandon C [6s 3c Jh Tc]
Dealt to MiamiBlues [As Qs Jd 7s]
Dealt to Curtis B [9c 7h 8d 9d]
Dealt to Charles A [Ad 9s Js 3s]
Brandon C: folds
MiamiBlues: raises €0.50 to €0.70
Curtis B: calls €0.70
Charles A: folds
Cassandra O: folds
Avery I: folds
*** FLOP *** [Qh 9h 2c]
MiamiBlues: bets €0.81
Curtis B: calls €0.81
*** TURN *** [Qh 9h 2c] [7d]
MiamiBlues: bets €2.50
Curtis B: raises €8.17 to €10.67
MiamiBlues: folds
Curtis B: mucks hand
*** SHOWDOWN ***
Curtis B: mucks hand
Uncalled bet (€8.17) returned to Curtis B
Curtis B collected €7.95 from pot
*** SUMMARY ***
Total pot €8.32 | Main pot €8.32 | Side pot €0.00 | Rake €0.37
Board [Qh 9h 2c 7d]
Seat 2: Brandon C folded before Flop
Seat 5: Charles A (button) folded before Flop
Seat 6: Cassandra O (small blind) folded before Flop
Seat 1: Avery I (big blind) folded before Flop
Seat 3: MiamiBlues folded before River
Seat 4: Curtis B mucked hand and won €7.95


**** **** **** **** **** **** **** ****


Run It Once Poker Hand #45242043:  Omaha Pot Limit (€0.10/€0.20) - 2020/05/24 18:35 UTC [2020/05/24 19:35 CET]
Table ID '45238934' 6-Max Seat #6 is the button
Seat 1: Avery I (€25.42 in chips)
Seat 2: Brandon C (€20.30 in chips)
Seat 3: MiamiBlues (€20 in chips)
Seat 4: Curtis B (€49.15 in chips)
Seat 6: Cassandra O (€20.55 in chips)
Avery I: posts small blind €0.10
Brandon C: posts big blind €0.20
*** HOLE CARDS ***
STP added: €0.80
Dealt to Avery I [9h 6s 5h 7s]
Dealt to Brandon C [3d 2h 9d 8c]
Dealt to MiamiBlues [2d Th 3s 5s]
Dealt to Curtis B [4s Ac 8s Qh]
Dealt to Cassandra O [Td Ts 7h 6h]
MiamiBlues: folds
Curtis B: folds
Cassandra O: raises €0.50 to €0.70
Avery I: raises €1.60 to €2.30
Brandon C: folds
Cassandra O: calls €1.60
*** FLOP *** [Qs 5c 8d]
Avery I: bets €2.69
Cassandra O: calls €2.69
*** TURN *** [Qs 5c 8d] [4c]
Avery I: bets €9.72
Cassandra O: raises €5.84 to €15.56 and is all-in
Avery I: calls €5.84
*** RIVER *** [Qs 5c 8d 4c] [6d]
*** SHOWDOWN ***
Avery I shows [9h 6s 5h 7s] for Straight [9h 8d 7s 6d 5c]
Avery I collected €40.24 from pot
*** SUMMARY ***
Total pot €42.10 | Main pot €41.30 | Side pot €0.00 | STP €0.80 | Rake €1.86
Board [Qs 5c 8d 4c 6d]
Seat 3: MiamiBlues folded before Flop
Seat 4: Curtis B folded before Flop
Seat 2: Brandon C (big blind) folded before Flop
Seat 1: Avery I (small blind) showed [9h 6s 5h 7s] and won €40.24 with Straight 5 to 9
Seat 6: Cassandra O (button) mucked [Td Ts 7h 6h] and lost


**** **** **** **** **** **** **** ****


Run It Once Poker Hand #45242056:  Omaha Pot Limit (€0.10/€0.20) - 2020/05/24 18:36 UTC [2020/05/24 19:36 CET]
Table ID '45238934' 6-Max Seat #1 is the button
Seat 1: Avery I (€45.11 in chips)
Seat 2: Brandon C (€20.10 in chips)
Seat 3: MiamiBlues (€20 in chips)
Seat 4: Curtis B (€49.15 in chips)
Seat 6: Cassandra O (€20 in chips)
Brandon C: posts small blind €0.10
MiamiBlues: posts big blind €0.20
*** HOLE CARDS ***
Dealt to Brandon C [Kd Ad 5h 7s]
Dealt to MiamiBlues [Kc 8s 9c Ks]
Dealt to Curtis B [2h 8h Td 9d]
Dealt to Cassandra O [Tc 6h As Jd]
Dealt to Avery I [2d Qd Qc Ah]
Curtis B: folds
Cassandra O: folds
Avery I: raises €0.50 to €0.70
Brandon C: folds
MiamiBlues: raises €1.50 to €2.20
Avery I: folds
*** SHOWDOWN ***
MiamiBlues: mucks hand
Uncalled bet (€1.50) returned to MiamiBlues
MiamiBlues collected €1.50 from pot
*** SUMMARY ***
Total pot €1.50 | Main pot €1.50 | Side pot €0.00 | Rake €0.00
Seat 4: Curtis B folded before Flop
Seat 6: Cassandra O folded before Flop
Seat 2: Brandon C (small blind) folded before Flop
Seat 1: Avery I (button) folded before Flop
Seat 3: MiamiBlues (big blind) mucked hand and won €1.50


**** **** **** **** **** **** **** ****


Run It Once Poker Hand #45242065:  Omaha Pot Limit (€0.10/€0.20) - 2020/05/24 18:37 UTC [2020/05/24 19:37 CET]
Table ID '45238934' 6-Max Seat #2 is the button
Seat 1: Avery I (€44.41 in chips)
Seat 2: Brandon C (€20 in chips)
Seat 3: MiamiBlues (€20.80 in chips)
Seat 6: Cassandra O (€20 in chips)
MiamiBlues: posts small blind €0.10
Cassandra O: posts big blind €0.20
*** HOLE CARDS ***
Dealt to MiamiBlues [7d 2d 6c 8h]
Dealt to Cassandra O [3c 3s 5s Kd]
Dealt to Avery I [Kh 9h Qc 8d]
Dealt to Brandon C [Ac 3d 7s 6d]
Avery I: raises €0.50 to €0.70
Brandon C: folds
MiamiBlues: folds
Cassandra O: folds
*** SHOWDOWN ***
Avery I: mucks hand
Uncalled bet (€0.50) returned to Avery I
Avery I collected €0.50 from pot
*** SUMMARY ***
Total pot €0.50 | Main pot €0.50 | Side pot €0.00 | Rake €0.00
Seat 2: Brandon C (button) folded before Flop
Seat 3: MiamiBlues (small blind) folded before Flop
Seat 6: Cassandra O (big blind) folded before Flop
Seat 1: Avery I mucked hand and won €0.50


**** **** **** **** **** **** **** ****


Run It Once Poker Hand #45242067:  Omaha Pot Limit (€0.10/€0.20) - 2020/05/24 18:37 UTC [2020/05/24 19:37 CET]
Table ID '45238934' 6-Max Seat #3 is the button
Seat 1: Avery I (€44.71 in chips)
Seat 2: Brandon C (€20 in chips)
Seat 3: MiamiBlues (€20.70 in chips)
Seat 6: Cassandra O (€20 in chips)
Cassandra O: posts small blind €0.10
Avery I: posts big blind €0.20
*** HOLE CARDS ***
Dealt to Cassandra O [2h 2c Js Jc]
Dealt to Avery I [4d Jd Ks Kh]
Dealt to Brandon C [Td Qc 2d 9h]
Dealt to MiamiBlues [5d 3d 5s Tc]
Brandon C: folds
MiamiBlues: folds
Cassandra O: raises €0.40 to €0.60
Avery I: calls €0.40
*** FLOP *** [5h Jh 8d]
Cassandra O: bets €0.86
Avery I: calls €0.86
*** TURN *** [5h Jh 8d] [Ah]
Cassandra O: checks
Avery I: checks
*** RIVER *** [5h Jh 8d Ah] [Kd]
Cassandra O: checks
Avery I: checks
*** SHOWDOWN ***
Avery I shows [4d Jd Ks Kh] for Three of Kind [Ah Ks Kh Kd Jh]
Avery I collected €2.79 from pot
*** SUMMARY ***
Total pot €2.92 | Main pot €2.92 | Side pot €0.00 | Rake €0.13
Board [5h Jh 8d Ah Kd]
Seat 2: Brandon C folded before Flop
Seat 3: MiamiBlues (button) folded before Flop
Seat 1: Avery I (big blind) showed [4d Jd Ks Kh] and won €2.79 with Three of Kind K's and A J
Seat 6: Cassandra O (small blind) mucked [2h 2c Js Jc] and lost


**** **** **** **** **** **** **** ****


Run It Once Poker Hand #45242072:  Omaha Pot Limit (€0.10/€0.20) - 2020/05/24 18:37 UTC [2020/05/24 19:37 CET]
Table ID '45238934' 6-Max Seat #6 is the button
Seat 1: Avery I (€46.04 in chips)
Seat 2: Brandon C (€20 in chips)
Seat 3: MiamiBlues (€20.70 in chips)
Seat 6: Cassandra O (€20 in chips)
Avery I: posts small blind €0.10
Brandon C: posts big blind €0.20
*** HOLE CARDS ***
Dealt to Avery I [Th 5d Ks 4h]
Dealt to Brandon C [2c 8s 7s Ac]
Dealt to MiamiBlues [Jc 5c Ah 5h]
Dealt to Cassandra O [4s 9s 9h 3c]
MiamiBlues: raises €0.50 to €0.70
Cassandra O: folds
Avery I: folds
Brandon C: calls €0.50
*** FLOP *** [Qh Ad Kh]
Brandon C: checks
MiamiBlues: bets €0.72
Brandon C: folds
MiamiBlues: mucks hand
*** SHOWDOWN ***
MiamiBlues: mucks hand
Uncalled bet (€0.72) returned to MiamiBlues
MiamiBlues collected €1.43 from pot
*** SUMMARY ***
Total pot €1.50 | Main pot €1.50 | Side pot €0.00 | Rake €0.07
Board [Qh Ad Kh]
Seat 6: Cassandra O (button) folded before Flop
Seat 1: Avery I (small blind) folded before Flop
Seat 2: Brandon C (big blind) folded before Turn
Seat 3: MiamiBlues mucked hand and won €1.43


**** **** **** **** **** **** **** ****


Run It Once Poker Hand #45242077:  Omaha Pot Limit (€0.10/€0.20) - 2020/05/24 18:38 UTC [2020/05/24 19:38 CET]
Table ID '45238934' 6-Max Seat #1 is the button
Seat 1: Avery I (€45.94 in chips)
Seat 2: Brandon C (€20 in chips)
Seat 3: MiamiBlues (€21.43 in chips)
Seat 6: Cassandra O (€20 in chips)
Brandon C: posts small blind €0.10
MiamiBlues: posts big blind €0.20
*** HOLE CARDS ***
Dealt to Brandon C [9s Kd 2h 5s]
Dealt to MiamiBlues [3c 8h 9c 5c]
Dealt to Cassandra O [8c 5h Qs Ad]
Dealt to Avery I [3h 5d Qd Qh]
Cassandra O: folds
Avery I: raises €0.50 to €0.70
Brandon C: folds
MiamiBlues: folds
*** SHOWDOWN ***
Avery I: mucks hand
Uncalled bet (€0.50) returned to Avery I
Avery I collected €0.50 from pot
*** SUMMARY ***
Total pot €0.50 | Main pot €0.50 | Side pot €0.00 | Rake €0.00
Seat 6: Cassandra O folded before Flop
Seat 2: Brandon C (small blind) folded before Flop
Seat 3: MiamiBlues (big blind) folded before Flop
Seat 1: Avery I (button) mucked hand and won €0.50


**** **** **** **** **** **** **** ****


Run It Once Poker Hand #45242083:  Omaha Pot Limit (€0.10/€0.20) - 2020/05/24 18:38 UTC [2020/05/24 19:38 CET]
Table ID '45238934' 6-Max Seat #2 is the button
Seat 1: Avery I (€46.24 in chips)
Seat 2: Brandon C (€20 in chips)
Seat 3: MiamiBlues (€21.23 in chips)
Seat 4: Trae G (€20 in chips)
Seat 6: Cassandra O (€20 in chips)
MiamiBlues: posts small blind €0.10
Trae G: posts big blind €0.20
*** HOLE CARDS ***
Dealt to MiamiBlues [2h 3d 8c 6s]
Dealt to Trae G [Ks 4h 5c Jh]
Dealt to Cassandra O [Qs 3h 3c 5h]
Dealt to Avery I [Qh 6d 5d 4c]
Dealt to Brandon C [9h Tc 7d Ad]
Cassandra O: folds
Avery I: folds
Brandon C: raises €0.50 to €0.70
MiamiBlues: folds
Trae G: folds
*** SHOWDOWN ***
Brandon C: mucks hand
Uncalled bet (€0.50) returned to Brandon C
Brandon C collected €0.50 from pot
*** SUMMARY ***
Total pot €0.50 | Main pot €0.50 | Side pot €0.00 | Rake €0.00
Seat 6: Cassandra O folded before Flop
Seat 1: Avery I folded before Flop
Seat 3: MiamiBlues (small blind) folded before Flop
Seat 4: Trae G (big blind) folded before Flop
Seat 2: Brandon C (button) mucked hand and won €0.50


**** **** **** **** **** **** **** ****


Run It Once Poker Hand #45242087:  Omaha Pot Limit (€0.10/€0.20) - 2020/05/24 18:38 UTC [2020/05/24 19:38 CET]
Table ID '45238934' 6-Max Seat #3 is the button
Seat 1: Avery I (€46.24 in chips)
Seat 2: Brandon C (€20.30 in chips)
Seat 3: MiamiBlues (€21.13 in chips)
Seat 4: Trae G (€19.80 in chips)
Seat 5: Kimberly Z (€20 in chips)
Seat 6: Cassandra O (€20 in chips)
Trae G: posts small blind €0.10
Kimberly Z: posts big blind €0.20
*** HOLE CARDS ***
Dealt to Trae G [7d Kc 4h 2h]
Dealt to Kimberly Z [2s As 9d Kh]
Dealt to Cassandra O [Ac Th 7c 7h]
Dealt to Avery I [6d 5c Jh 9h]
Dealt to Brandon C [8c Ad 9s 5h]
Dealt to MiamiBlues [8h 3c Js 4d]
Cassandra O: raises €0.50 to €0.70
Avery I: folds
Brandon C: folds
MiamiBlues: folds
Trae G: folds
Kimberly Z: folds
*** SHOWDOWN ***
Cassandra O: mucks hand
Uncalled bet (€0.50) returned to Cassandra O
Cassandra O collected €0.50 from pot
*** SUMMARY ***
Total pot €0.50 | Main pot €0.50 | Side pot €0.00 | Rake €0.00
Seat 1: Avery I folded before Flop
Seat 2: Brandon C folded before Flop
Seat 3: MiamiBlues (button) folded before Flop
Seat 4: Trae G (small blind) folded before Flop
Seat 5: Kimberly Z (big blind) folded before Flop
Seat 6: Cassandra O mucked hand and won €0.50


**** **** **** **** **** **** **** ****


Run It Once Poker Hand #45242091:  Omaha Pot Limit (€0.10/€0.20) - 2020/05/24 18:38 UTC [2020/05/24 19:38 CET]
Table ID '45238934' 6-Max Seat #4 is the button
Seat 1: Avery I (€46.24 in chips)
Seat 2: Brandon C (€20.30 in chips)
Seat 3: MiamiBlues (€21.13 in chips)
Seat 4: Trae G (€19.70 in chips)
Seat 5: Kimberly Z (€19.80 in chips)
Seat 6: Cassandra O (€20.30 in chips)
Kimberly Z: posts small blind €0.10
Cassandra O: posts big blind €0.20
*** HOLE CARDS ***
Dealt to Kimberly Z [8c 6c 4c Ks]
Dealt to Cassandra O [Jd 8s Kc 9s]
Dealt to Avery I [8d Th 2s Qc]
Dealt to Brandon C [Ts Jh 5h 2c]
Dealt to MiamiBlues [5c 2h 7s 4h]
Dealt to Trae G [7c Js 3s 2d]
Avery I: folds
Brandon C: folds
MiamiBlues: folds
Trae G: folds
Kimberly Z: folds
*** SHOWDOWN ***
Cassandra O: mucks hand
Cassandra O collected €0.30 from pot
*** SUMMARY ***
Total pot €0.30 | Main pot €0.30 | Side pot €0.00 | Rake €0.00
Seat 1: Avery I folded before Flop
Seat 2: Brandon C folded before Flop
Seat 3: MiamiBlues folded before Flop
Seat 4: Trae G (button) folded before Flop
Seat 5: Kimberly Z (small blind) folded before Flop
Seat 6: Cassandra O (big blind) mucked hand and won €0.30


**** **** **** **** **** **** **** ****


Run It Once Poker Hand #45242093:  Omaha Pot Limit (€0.10/€0.20) - 2020/05/24 18:39 UTC [2020/05/24 19:39 CET]
Table ID '45238934' 6-Max Seat #5 is the button
Seat 1: Avery I (€46.24 in chips)
Seat 2: Brandon C (€20.30 in chips)
Seat 3: MiamiBlues (€21.13 in chips)
Seat 4: Trae G (€19.70 in chips)
Seat 5: Kimberly Z (€19.70 in chips)
Seat 6: Cassandra O (€20.40 in chips)
Cassandra O: posts small blind €0.10
Avery I: posts big blind €0.20
*** HOLE CARDS ***
Dealt to Cassandra O [Kd 2s 9c Js]
Dealt to Avery I [4c Qs Kc 6c]
Dealt to Brandon C [2h 6s 3d 8c]
Dealt to MiamiBlues [5h 7c Th Jc]
Dealt to Trae G [4d 2c As 8d]
Dealt to Kimberly Z [Ah Tc 4s Td]
Brandon C: folds
MiamiBlues: folds
Trae G: folds
Kimberly Z: folds
Cassandra O: folds
*** SHOWDOWN ***
Avery I: mucks hand
Avery I collected €0.30 from pot
*** SUMMARY ***
Total pot €0.30 | Main pot €0.30 | Side pot €0.00 | Rake €0.00
Seat 2: Brandon C folded before Flop
Seat 3: MiamiBlues folded before Flop
Seat 4: Trae G folded before Flop
Seat 5: Kimberly Z (button) folded before Flop
Seat 6: Cassandra O (small blind) folded before Flop
Seat 1: Avery I (big blind) mucked hand and won €0.30


**** **** **** **** **** **** **** ****


Run It Once Poker Hand #45242095:  Omaha Pot Limit (€0.10/€0.20) - 2020/05/24 18:39 UTC [2020/05/24 19:39 CET]
Table ID '45238934' 6-Max Seat #6 is the button
Seat 1: Avery I (€46.34 in chips)
Seat 2: Brandon C (€20.30 in chips)
Seat 3: MiamiBlues (€21.13 in chips)
Seat 4: Trae G (€19.70 in chips)
Seat 5: Kimberly Z (€19.70 in chips)
Seat 6: Cassandra O (€20.30 in chips)
Avery I: posts small blind €0.10
Brandon C: posts big blind €0.20
*** HOLE CARDS ***
Dealt to Avery I [2h 7s Ac 9h]
Dealt to Brandon C [5s 8c 8h 4h]
Dealt to MiamiBlues [8d 3d Jh 7h]
Dealt to Trae G [3s Kh 4s 9d]
Dealt to Kimberly Z [As Kc Qd 5h]
Dealt to Cassandra O [Tc Ks Ah 7d]
MiamiBlues: folds
Trae G: folds
Kimberly Z: folds
Cassandra O: raises €0.50 to €0.70
Avery I: folds
Brandon C: folds
*** SHOWDOWN ***
Cassandra O: mucks hand
Uncalled bet (€0.50) returned to Cassandra O
Cassandra O collected €0.50 from pot
*** SUMMARY ***
Total pot €0.50 | Main pot €0.50 | Side pot €0.00 | Rake €0.00
Seat 3: MiamiBlues folded before Flop
Seat 4: Trae G folded before Flop
Seat 5: Kimberly Z folded before Flop
Seat 1: Avery I (small blind) folded before Flop
Seat 2: Brandon C (big blind) folded before Flop
Seat 6: Cassandra O (button) mucked hand and won €0.50


**** **** **** **** **** **** **** ****


Run It Once Poker Hand #45242098:  Omaha Pot Limit (€0.10/€0.20) - 2020/05/24 18:39 UTC [2020/05/24 19:39 CET]
Table ID '45238934' 6-Max Seat #1 is the button
Seat 1: Avery I (€46.24 in chips)
Seat 2: Brandon C (€20.10 in chips)
Seat 3: MiamiBlues (€21.13 in chips)
Seat 4: Trae G (€19.70 in chips)
Seat 5: Kimberly Z (€19.70 in chips)
Seat 6: Cassandra O (€20.60 in chips)
Brandon C: posts small blind €0.10
MiamiBlues: posts big blind €0.20
*** HOLE CARDS ***
Dealt to Brandon C [3c Kd 5s 3h]
Dealt to MiamiBlues [Th 4c Ad 5d]
Dealt to Trae G [6s 2c 7c 5c]
Dealt to Kimberly Z [4d 6h 8s 2s]
Dealt to Cassandra O [Jc Kc 6c 8h]
Dealt to Avery I [9c Ah 6d 4h]
Trae G: folds
Kimberly Z: folds
Cassandra O: folds
Avery I: raises €0.50 to €0.70
Brandon C: folds
MiamiBlues: folds
*** SHOWDOWN ***
Avery I: mucks hand
Uncalled bet (€0.50) returned to Avery I
Avery I collected €0.50 from pot
*** SUMMARY ***
Total pot €0.50 | Main pot €0.50 | Side pot €0.00 | Rake €0.00
Seat 4: Trae G folded before Flop
Seat 5: Kimberly Z folded before Flop
Seat 6: Cassandra O folded before Flop
Seat 2: Brandon C (small blind) folded before Flop
Seat 3: MiamiBlues (big blind) folded before Flop
Seat 1: Avery I (button) mucked hand and won €0.50


**** **** **** **** **** **** **** ****


Run It Once Poker Hand #45242113:  Omaha Pot Limit (€0.10/€0.20) - 2020/05/24 18:40 UTC [2020/05/24 19:40 CET]
Table ID '45238934' 6-Max Seat #2 is the button
Seat 1: Avery I (€46.54 in chips)
Seat 2: Brandon C (€20 in chips)
Seat 3: MiamiBlues (€20.93 in chips)
Seat 4: Trae G (€19.70 in chips)
Seat 5: Kimberly Z (€19.70 in chips)
Seat 6: Cassandra O (€20.60 in chips)
MiamiBlues: posts small blind €0.10
Trae G: posts big blind €0.20
*** HOLE CARDS ***
Dealt to MiamiBlues [3h Ks 9d 4h]
Dealt to Trae G [7h 4s 3s 9s]
Dealt to Kimberly Z [2c 4d 8c 3c]
Dealt to Cassandra O [Ac Qd 6s Kh]
Dealt to Avery I [Kd Th Qs Ad]
Dealt to Brandon C [As 4c Tc Jh]
Kimberly Z: folds
Cassandra O: folds
Avery I: raises €0.50 to €0.70
Brandon C: calls €0.70
MiamiBlues: folds
Trae G: folds
*** FLOP *** [Ah 7s 6h]
Avery I: checks
Brandon C: bets €1.22
Avery I: calls €1.22
*** TURN *** [Ah 7s 6h] [3d]
Avery I: checks
Brandon C: bets €2.96
Avery I: folds
Brandon C: mucks hand
*** SHOWDOWN ***
Brandon C: mucks hand
Uncalled bet (€2.96) returned to Brandon C
Brandon C collected €3.95 from pot
*** SUMMARY ***
Total pot €4.14 | Main pot €4.14 | Side pot €0.00 | Rake €0.19
Board [Ah 7s 6h 3d]
Seat 5: Kimberly Z folded before Flop
Seat 6: Cassandra O folded before Flop
Seat 3: MiamiBlues (small blind) folded before Flop
Seat 4: Trae G (big blind) folded before Flop
Seat 1: Avery I folded before River
Seat 2: Brandon C (button) mucked hand and won €3.95


**** **** **** **** **** **** **** ****


Run It Once Poker Hand #45242125:  Omaha Pot Limit (€0.10/€0.20) - 2020/05/24 18:42 UTC [2020/05/24 19:42 CET]
Table ID '45238934' 6-Max Seat #3 is the button
Seat 1: Avery I (€44.62 in chips)
Seat 2: Brandon C (€22.03 in chips)
Seat 3: MiamiBlues (€20.83 in chips)
Seat 4: Trae G (€19.50 in chips)
Seat 6: Cassandra O (€20.60 in chips)
Trae G: posts small blind €0.10
Cassandra O: posts big blind €0.20
*** HOLE CARDS ***
Dealt to Trae G [Kd 2c Jh Qh]
Dealt to Cassandra O [6s 3s 6c Jd]
Dealt to Avery I [Js Kh 2d Qd]
Dealt to Brandon C [Ks As Th 5d]
Dealt to MiamiBlues [9c 9h 6h 4d]
Avery I: folds
Brandon C: raises €0.50 to €0.70
MiamiBlues: folds
Trae G: folds
Cassandra O: folds
*** SHOWDOWN ***
Brandon C: mucks hand
Uncalled bet (€0.50) returned to Brandon C
Brandon C collected €0.50 from pot
*** SUMMARY ***
Total pot €0.50 | Main pot €0.50 | Side pot €0.00 | Rake €0.00
Seat 1: Avery I folded before Flop
Seat 3: MiamiBlues (button) folded before Flop
Seat 4: Trae G (small blind) folded before Flop
Seat 6: Cassandra O (big blind) folded before Flop
Seat 2: Brandon C mucked hand and won €0.50


**** **** **** **** **** **** **** ****


Run It Once Poker Hand #45242130:  Omaha Pot Limit (€0.10/€0.20) - 2020/05/24 18:42 UTC [2020/05/24 19:42 CET]
Table ID '45238934' 6-Max Seat #4 is the button
Seat 1: Avery I (€44.62 in chips)
Seat 2: Brandon C (€22.33 in chips)
Seat 3: MiamiBlues (€20.83 in chips)
Seat 4: Trae G (€19.40 in chips)
Seat 6: Cassandra O (€20.40 in chips)
Cassandra O: posts small blind €0.10
Avery I: posts big blind €0.20
*** HOLE CARDS ***
Dealt to Cassandra O [2h 8d Kh 2s]
Dealt to Avery I [7d 5c Th 8c]
Dealt to Brandon C [7c Kd Jd 8h]
Dealt to MiamiBlues [6s 6h 7s Td]
Dealt to Trae G [8s 2c 4d Ac]
Brandon C: folds
MiamiBlues: folds
Trae G: folds
Cassandra O: folds
*** SHOWDOWN ***
Avery I: mucks hand
Avery I collected €0.30 from pot
*** SUMMARY ***
Total pot €0.30 | Main pot €0.30 | Side pot €0.00 | Rake €0.00
Seat 2: Brandon C folded before Flop
Seat 3: MiamiBlues folded before Flop
Seat 4: Trae G (button) folded before Flop
Seat 6: Cassandra O (small blind) folded before Flop
Seat 1: Avery I (big blind) mucked hand and won €0.30


**** **** **** **** **** **** **** ****


Run It Once Poker Hand #45242134:  Omaha Pot Limit (€0.10/€0.20) - 2020/05/24 18:42 UTC [2020/05/24 19:42 CET]
Table ID '45238934' 6-Max Seat #6 is the button
Seat 1: Avery I (€44.72 in chips)
Seat 2: Brandon C (€22.33 in chips)
Seat 3: MiamiBlues (€20.83 in chips)
Seat 4: Trae G (€19.40 in chips)
Seat 6: Cassandra O (€20.30 in chips)
Avery I: posts small blind €0.10
Brandon C: posts big blind €0.20
*** HOLE CARDS ***
Dealt to Avery I [5c Qd Tc 9h]
Dealt to Brandon C [3d 2d 4c 4d]
Dealt to MiamiBlues [7h 8h 9s 5s]
Dealt to Trae G [7s 3h Js 8d]
Dealt to Cassandra O [3c 4s 9d 6h]
MiamiBlues: raises €0.50 to €0.70
Trae G: folds
Cassandra O: folds
Avery I: folds
Brandon C: folds
*** SHOWDOWN ***
MiamiBlues: mucks hand
Uncalled bet (€0.50) returned to MiamiBlues
MiamiBlues collected €0.50 from pot
*** SUMMARY ***
Total pot €0.50 | Main pot €0.50 | Side pot €0.00 | Rake €0.00
Seat 4: Trae G folded before Flop
Seat 6: Cassandra O (button) folded before Flop
Seat 1: Avery I (small blind) folded before Flop
Seat 2: Brandon C (big blind) folded before Flop
Seat 3: MiamiBlues mucked hand and won €0.50


**** **** **** **** **** **** **** ****


Run It Once Poker Hand #45242136:  Omaha Pot Limit (€0.10/€0.20) - 2020/05/24 18:43 UTC [2020/05/24 19:43 CET]
Table ID '45238934' 6-Max Seat #1 is the button
Seat 1: Avery I (€44.62 in chips)
Seat 2: Brandon C (€22.13 in chips)
Seat 3: MiamiBlues (€21.13 in chips)
Seat 4: Trae G (€19.40 in chips)
Seat 6: Cassandra O (€20.30 in chips)
Brandon C: posts small blind €0.10
MiamiBlues: posts big blind €0.20
*** HOLE CARDS ***
Dealt to Brandon C [Qs 7c Tc 4d]
Dealt to MiamiBlues [8s Js 6h 4h]
Dealt to Trae G [4c Th Ts Jc]
Dealt to Cassandra O [8c 9s 5h Ac]
Dealt to Avery I [Qd Kc 3h Qc]
Trae G: folds
Cassandra O: raises €0.50 to €0.70
Avery I: calls €0.70
Brandon C: folds
MiamiBlues: calls €0.50
*** FLOP *** [9d 2c Qh]
MiamiBlues: checks
Cassandra O: bets €1.58
Avery I: calls €1.58
MiamiBlues: folds
*** TURN *** [9d 2c Qh] [9c]
Cassandra O: bets €2.56
Avery I: calls €2.56
*** RIVER *** [9d 2c Qh 9c] [5d]
Cassandra O: bets €7.51
Avery I: raises €25.03 to €32.54
Cassandra O: calls €7.95 and is all-in
*** SHOWDOWN ***
Avery I shows [Qd Kc 3h Qc] for Full House [Qh Qd Qc 9d 9c]
Uncalled bet (€17.08) returned to Avery I
Avery I collected €39.54 from pot
*** SUMMARY ***
Total pot €41.40 | Main pot €41.40 | Side pot €0.00 | Rake €1.86
Board [9d 2c Qh 9c 5d]
Seat 4: Trae G folded before Flop
Seat 2: Brandon C (small blind) folded before Flop
Seat 3: MiamiBlues (big blind) folded before Turn
Seat 1: Avery I (button) showed [Qd Kc 3h Qc] and won €39.54 with Full House Q's and 9's
Seat 6: Cassandra O mucked [8c 9s 5h Ac] and lost


**** **** **** **** **** **** **** ****


Run It Once Poker Hand #45242149:  Omaha Pot Limit (€0.10/€0.20) - 2020/05/24 18:44 UTC [2020/05/24 19:44 CET]
Table ID '45238934' 6-Max Seat #2 is the button
Seat 1: Avery I (€63.86 in chips)
Seat 2: Brandon C (€22.03 in chips)
Seat 3: MiamiBlues (€20.43 in chips)
Seat 4: Trae G (€19.40 in chips)
Seat 6: Cassandra O (€20 in chips)
MiamiBlues: posts small blind €0.10
Trae G: posts big blind €0.20
*** HOLE CARDS ***
Dealt to MiamiBlues [Kh 9d Td Ad]
Dealt to Trae G [Ts 3h 3c 7h]
Dealt to Cassandra O [4h Qc Jc 2d]
Dealt to Avery I [7s Tc 5c 8d]
Dealt to Brandon C [Js Jh Ac Jd]
Cassandra O: folds
Avery I: folds
Brandon C: folds
MiamiBlues: raises €0.40 to €0.60
Trae G: folds
*** SHOWDOWN ***
MiamiBlues: mucks hand
Uncalled bet (€0.40) returned to MiamiBlues
MiamiBlues collected €0.40 from pot
*** SUMMARY ***
Total pot €0.40 | Main pot €0.40 | Side pot €0.00 | Rake €0.00
Seat 6: Cassandra O folded before Flop
Seat 1: Avery I folded before Flop
Seat 2: Brandon C (button) folded before Flop
Seat 4: Trae G (big blind) folded before Flop
Seat 3: MiamiBlues (small blind) mucked hand and won €0.40


**** **** **** **** **** **** **** ****


Run It Once Poker Hand #45242160:  Omaha Pot Limit (€0.10/€0.20) - 2020/05/24 18:44 UTC [2020/05/24 19:44 CET]
Table ID '45238934' 6-Max Seat #3 is the button
Seat 1: Avery I (€63.86 in chips)
Seat 2: Brandon C (€22.03 in chips)
Seat 3: MiamiBlues (€20.63 in chips)
Seat 4: Trae G (€19.20 in chips)
Seat 5: Kimberly Z (€19.70 in chips)
Seat 6: Cassandra O (€20 in chips)
Trae G: posts small blind €0.10
Kimberly Z: posts big blind €0.20
*** HOLE CARDS ***
Dealt to Trae G [5d Kh 8h 6c]
Dealt to Kimberly Z [Ad 3s 2s Ac]
Dealt to Cassandra O [2h 6d Qd 9h]
Dealt to Avery I [Td 3c 4s 4c]
Dealt to Brandon C [8d 8c 4h 2d]
Dealt to MiamiBlues [9c Th Ah 4d]
Cassandra O: folds
Avery I: folds
Brandon C: folds
MiamiBlues: raises €0.50 to €0.70
Trae G: folds
Kimberly Z: calls €0.50
*** FLOP *** [As Qs 7d]
Kimberly Z: checks
MiamiBlues: bets €0.72
Kimberly Z: raises €2.87 to €3.59
MiamiBlues: folds
Kimberly Z: mucks hand
*** SHOWDOWN ***
Kimberly Z: mucks hand
Uncalled bet (€2.87) returned to Kimberly Z
Kimberly Z collected €2.81 from pot
*** SUMMARY ***
Total pot €2.94 | Main pot €2.94 | Side pot €0.00 | Rake €0.13
Board [As Qs 7d]
Seat 6: Cassandra O folded before Flop
Seat 1: Avery I folded before Flop
Seat 2: Brandon C folded before Flop
Seat 4: Trae G (small blind) folded before Flop
Seat 3: MiamiBlues (button) folded before Turn
Seat 5: Kimberly Z (big blind) mucked hand and won €2.81


**** **** **** **** **** **** **** ****


Run It Once Poker Hand #45242182:  Omaha Pot Limit (€0.10/€0.20) - 2020/05/24 18:45 UTC [2020/05/24 19:45 CET]
Table ID '45238934' 6-Max Seat #4 is the button
Seat 1: Avery I (€63.86 in chips)
Seat 2: Brandon C (€22.03 in chips)
Seat 3: MiamiBlues (€20 in chips)
Seat 4: Trae G (€19.10 in chips)
Seat 5: Kimberly Z (€21.09 in chips)
Seat 6: Cassandra O (€20 in chips)
Kimberly Z: posts small blind €0.10
Cassandra O: posts big blind €0.20
*** HOLE CARDS ***
Dealt to Kimberly Z [7s 2c Kc Ad]
Dealt to Cassandra O [8c Qc 2h Tc]
Dealt to Avery I [7d 4d Ts Ks]
Dealt to Brandon C [Jh 7h 3s Qs]
Dealt to MiamiBlues [Ac 8s 8d 5d]
Dealt to Trae G [As 6d Qd Kd]
Avery I: folds
Brandon C: folds
MiamiBlues: folds
Trae G: raises €0.50 to €0.70
Kimberly Z: folds
Cassandra O: folds
*** SHOWDOWN ***
Trae G: mucks hand
Uncalled bet (€0.50) returned to Trae G
Trae G collected €0.50 from pot
*** SUMMARY ***
Total pot €0.50 | Main pot €0.50 | Side pot €0.00 | Rake €0.00
Seat 1: Avery I folded before Flop
Seat 2: Brandon C folded before Flop
Seat 3: MiamiBlues folded before Flop
Seat 5: Kimberly Z (small blind) folded before Flop
Seat 6: Cassandra O (big blind) folded before Flop
Seat 4: Trae G (button) mucked hand and won €0.50


**** **** **** **** **** **** **** ****


Run It Once Poker Hand #45242192:  Omaha Pot Limit (€0.10/€0.20) - 2020/05/24 18:46 UTC [2020/05/24 19:46 CET]
Table ID '45238934' 6-Max Seat #5 is the button
Seat 1: Avery I (€63.86 in chips)
Seat 2: Brandon C (€22.03 in chips)
Seat 3: MiamiBlues (€20 in chips)
Seat 4: Trae G (€19.40 in chips)
Seat 5: Kimberly Z (€20.99 in chips)
Seat 6: Cassandra O (€20 in chips)
Cassandra O: posts small blind €0.10
Avery I: posts big blind €0.20
*** HOLE CARDS ***
Dealt to Cassandra O [8h Jh Ac Js]
Dealt to Avery I [Ts 8s Tc 6s]
Dealt to Brandon C [7c 7h Ah Qs]
Dealt to MiamiBlues [8d 5c 4h 9d]
Dealt to Trae G [Kd 8c 2d 9h]
Dealt to Kimberly Z [Jd 3h Jc Qh]
Brandon C: folds
MiamiBlues: folds
Trae G: folds
Kimberly Z: folds
Cassandra O: raises €0.40 to €0.60
Avery I: calls €0.40
*** FLOP *** [5h Td Ad]
Cassandra O: bets €0.86
Avery I: raises €1.94 to €2.80
Cassandra O: folds
Avery I: mucks hand
*** SHOWDOWN ***
Avery I: mucks hand
Uncalled bet (€1.94) returned to Avery I
Avery I collected €2.79 from pot
*** SUMMARY ***
Total pot €2.92 | Main pot €2.92 | Side pot €0.00 | Rake €0.13
Board [5h Td Ad]
Seat 2: Brandon C folded before Flop
Seat 3: MiamiBlues folded before Flop
Seat 4: Trae G folded before Flop
Seat 5: Kimberly Z (button) folded before Flop
Seat 6: Cassandra O (small blind) folded before Turn
Seat 1: Avery I (big blind) mucked hand and won €2.79


**** **** **** **** **** **** **** ****


Run It Once Poker Hand #45242207:  Omaha Pot Limit (€0.10/€0.20) - 2020/05/24 18:46 UTC [2020/05/24 19:46 CET]
Table ID '45238934' 6-Max Seat #6 is the button
Seat 1: Avery I (€65.19 in chips)
Seat 2: Brandon C (€22.03 in chips)
Seat 3: MiamiBlues (€20 in chips)
Seat 4: Trae G (€19.40 in chips)
Seat 5: Kimberly Z (€20.99 in chips)
Seat 6: Cassandra O (€20 in chips)
Avery I: posts small blind €0.10
Brandon C: posts big blind €0.20
*** HOLE CARDS ***
Dealt to Avery I [8s 5s 9h Ac]
Dealt to Brandon C [2c Td 2d 3c]
Dealt to MiamiBlues [4h Qh 8d 6c]
Dealt to Trae G [Jc 3s 8h 2h]
Dealt to Kimberly Z [Ad 7d Jh 4d]
Dealt to Cassandra O [6h Ks 6s 9s]
MiamiBlues: folds
Trae G: folds
Kimberly Z: folds
Cassandra O: folds
Avery I: folds
*** SHOWDOWN ***
Brandon C: mucks hand
Brandon C collected €0.30 from pot
*** SUMMARY ***
Total pot €0.30 | Main pot €0.30 | Side pot €0.00 | Rake €0.00
Seat 3: MiamiBlues folded before Flop
Seat 4: Trae G folded before Flop
Seat 5: Kimberly Z folded before Flop
Seat 6: Cassandra O (button) folded before Flop
Seat 1: Avery I (small blind) folded before Flop
Seat 2: Brandon C (big blind) mucked hand and won €0.30


**** **** **** **** **** **** **** ****


Run It Once Poker Hand #45242217:  Omaha Pot Limit (€0.10/€0.20) - 2020/05/24 18:47 UTC [2020/05/24 19:47 CET]
Table ID '45238934' 6-Max Seat #1 is the button
Seat 1: Avery I (€65.09 in chips)
Seat 2: Brandon C (€22.13 in chips)
Seat 3: MiamiBlues (€20 in chips)
Seat 4: Trae G (€19.40 in chips)
Seat 5: Kimberly Z (€20.99 in chips)
Seat 6: Cassandra O (€20 in chips)
Brandon C: posts small blind €0.10
MiamiBlues: posts big blind €0.20
*** HOLE CARDS ***
Dealt to Brandon C [3s 2h 6h 2c]
Dealt to MiamiBlues [Kh Qd 6c Ad]
Dealt to Trae G [9d Js 4c 9h]
Dealt to Kimberly Z [4h 7h 9c 5h]
Dealt to Cassandra O [3d 7d Jh Kc]
Dealt to Avery I [5c Qc 6d 9s]
Trae G: folds
Kimberly Z: folds
Cassandra O: folds
Avery I: raises €0.50 to €0.70
Brandon C: folds
MiamiBlues: raises €1.50 to €2.20
Avery I: calls €1.50
*** FLOP *** [8c 4d Ks]
MiamiBlues: bets €1.50
Avery I: folds
MiamiBlues: mucks hand
*** SHOWDOWN ***
MiamiBlues: mucks hand
Uncalled bet (€1.50) returned to MiamiBlues
MiamiBlues collected €4.30 from pot
*** SUMMARY ***
Total pot €4.50 | Main pot €4.50 | Side pot €0.00 | Rake €0.20
Board [8c 4d Ks]
Seat 4: Trae G folded before Flop
Seat 5: Kimberly Z folded before Flop
Seat 6: Cassandra O folded before Flop
Seat 2: Brandon C (small blind) folded before Flop
Seat 1: Avery I (button) folded before Turn
Seat 3: MiamiBlues (big blind) mucked hand and won €4.30


**** **** **** **** **** **** **** ****


Run It Once Poker Hand #45242227:  Omaha Pot Limit (€0.10/€0.20) - 2020/05/24 18:48 UTC [2020/05/24 19:48 CET]
Table ID '45238934' 6-Max Seat #2 is the button
Seat 1: Avery I (€62.89 in chips)
Seat 2: Brandon C (€22.03 in chips)
Seat 3: MiamiBlues (€22.10 in chips)
Seat 4: Trae G (€19.40 in chips)
Seat 5: Kimberly Z (€20.99 in chips)
Seat 6: Cassandra O (€20 in chips)
MiamiBlues: posts small blind €0.10
Trae G: posts big blind €0.20
*** HOLE CARDS ***
Dealt to MiamiBlues [Ts Kh 9c Qc]
Dealt to Trae G [5s 2c Qh 5c]
Dealt to Kimberly Z [4h Ks 2s 9h]
Dealt to Cassandra O [As Kc 5h 9d]
Dealt to Avery I [2h Td 7c Ah]
Dealt to Brandon C [8d Tc 6h 9s]
Kimberly Z: folds
Cassandra O: folds
Avery I: raises €0.50 to €0.70
Brandon C: folds
MiamiBlues: calls €0.60
Trae G: folds
*** FLOP *** [4c Jh 7d]
MiamiBlues: checks
Avery I: checks
*** TURN *** [4c Jh 7d] [3h]
MiamiBlues: checks
Avery I: bets €1.15
MiamiBlues: folds
Avery I: mucks hand
*** SHOWDOWN ***
Avery I: mucks hand
Uncalled bet (€1.15) returned to Avery I
Avery I collected €1.53 from pot
*** SUMMARY ***
Total pot €1.60 | Main pot €1.60 | Side pot €0.00 | Rake €0.07
Board [4c Jh 7d 3h]
Seat 5: Kimberly Z folded before Flop
Seat 6: Cassandra O folded before Flop
Seat 2: Brandon C (button) folded before Flop
Seat 4: Trae G (big blind) folded before Flop
Seat 3: MiamiBlues (small blind) folded before River
Seat 1: Avery I mucked hand and won €1.53


**** **** **** **** **** **** **** ****


Run It Once Poker Hand #45242242:  Omaha Pot Limit (€0.10/€0.20) - 2020/05/24 18:48 UTC [2020/05/24 19:48 CET]
Table ID '45238934' 6-Max Seat #3 is the button
Seat 1: Avery I (€63.72 in chips)
Seat 2: Brandon C (€22.03 in chips)
Seat 3: MiamiBlues (€21.40 in chips)
Seat 4: Trae G (€19.20 in chips)
Seat 5: Kimberly Z (€20.99 in chips)
Seat 6: Cassandra O (€20 in chips)
Trae G: posts small blind €0.10
Kimberly Z: posts big blind €0.20
*** HOLE CARDS ***
Dealt to Trae G [4h Qs 3h Ad]
Dealt to Kimberly Z [9d 6h 5d 5h]
Dealt to Cassandra O [4s Qd Kh Kd]
Dealt to Avery I [6d Kc 8h Th]
Dealt to Brandon C [Qh Td As 9c]
Dealt to MiamiBlues [7s Ks 6c 4c]
Cassandra O: raises €0.50 to €0.70
Avery I: folds
Brandon C: folds
MiamiBlues: folds
Trae G: folds
Kimberly Z: folds
*** SHOWDOWN ***
Cassandra O: mucks hand
Uncalled bet (€0.50) returned to Cassandra O
Cassandra O collected €0.50 from pot
*** SUMMARY ***
Total pot €0.50 | Main pot €0.50 | Side pot €0.00 | Rake €0.00
Seat 1: Avery I folded before Flop
Seat 2: Brandon C folded before Flop
Seat 3: MiamiBlues (button) folded before Flop
Seat 4: Trae G (small blind) folded before Flop
Seat 5: Kimberly Z (big blind) folded before Flop
Seat 6: Cassandra O mucked hand and won €0.50


**** **** **** **** **** **** **** ****


Run It Once Poker Hand #45242252:  Omaha Pot Limit (€0.10/€0.20) - 2020/05/24 18:49 UTC [2020/05/24 19:49 CET]
Table ID '45238934' 6-Max Seat #4 is the button
Seat 1: Avery I (€63.72 in chips)
Seat 2: Brandon C (€22.03 in chips)
Seat 3: MiamiBlues (€21.40 in chips)
Seat 4: Trae G (€19.10 in chips)
Seat 5: Kimberly Z (€20.79 in chips)
Kimberly Z: posts small blind €0.10
Avery I: posts big blind €0.20
*** HOLE CARDS ***
Dealt to Kimberly Z [3s 8h 6s Qd]
Dealt to Avery I [9d Ts As 9c]
Dealt to Brandon C [Ah 7h 4s 2c]
Dealt to MiamiBlues [6d Ad 5c 9s]
Dealt to Trae G [4d 6c 6h Jd]
Brandon C: folds
MiamiBlues: raises €0.50 to €0.70
Trae G: folds
Kimberly Z: folds
Avery I: calls €0.50
*** FLOP *** [Tc 5d Th]
Avery I: checks
MiamiBlues: bets €0.50
Avery I: raises €0.90 to €1.40
MiamiBlues: folds
Avery I: mucks hand
*** SHOWDOWN ***
Avery I: mucks hand
Uncalled bet (€0.90) returned to Avery I
Avery I collected €2.39 from pot
*** SUMMARY ***
Total pot €2.50 | Main pot €2.50 | Side pot €0.00 | Rake €0.11
Board [Tc 5d Th]
Seat 2: Brandon C folded before Flop
Seat 4: Trae G (button) folded before Flop
Seat 5: Kimberly Z (small blind) folded before Flop
Seat 3: MiamiBlues folded before Turn
Seat 1: Avery I (big blind) mucked hand and won €2.39


**** **** **** **** **** **** **** ****


Run It Once Poker Hand #45242271:  Omaha Pot Limit (€0.10/€0.20) - 2020/05/24 18:50 UTC [2020/05/24 19:50 CET]
Table ID '45238934' 6-Max Seat #5 is the button
Seat 1: Avery I (€64.91 in chips)
Seat 2: Brandon C (€22.03 in chips)
Seat 3: MiamiBlues (€20.20 in chips)
Seat 4: Trae G (€19.10 in chips)
Seat 5: Kimberly Z (€20.69 in chips)
Avery I: posts small blind €0.10
Brandon C: posts big blind €0.20
*** HOLE CARDS ***
Dealt to Avery I [3c 9c 6h 8h]
Dealt to Brandon C [2h Jd Ah 6c]
Dealt to MiamiBlues [Ad Qh 2c 3h]
Dealt to Trae G [Th Qd Js 8s]
Dealt to Kimberly Z [4s 3d 4c 7h]
MiamiBlues: folds
Trae G: raises €0.50 to €0.70
Kimberly Z: folds
Avery I: folds
Brandon C: calls €0.50
*** FLOP *** [3s Qs 5h]
Brandon C: checks
Trae G: checks
*** TURN *** [3s Qs 5h] [7d]
Brandon C: checks
Trae G: bets €0.72
Brandon C: raises €2.87 to €3.59
Trae G: folds
Brandon C: mucks hand
*** SHOWDOWN ***
Brandon C: mucks hand
Uncalled bet (€2.87) returned to Brandon C
Brandon C collected €2.81 from pot
*** SUMMARY ***
Total pot €2.94 | Main pot €2.94 | Side pot €0.00 | Rake €0.13
Board [3s Qs 5h 7d]
Seat 3: MiamiBlues folded before Flop
Seat 5: Kimberly Z (button) folded before Flop
Seat 1: Avery I (small blind) folded before Flop
Seat 4: Trae G folded before River
Seat 2: Brandon C (big blind) mucked hand and won €2.81


**** **** **** **** **** **** **** ****


Run It Once Poker Hand #45242299:  Omaha Pot Limit (€0.10/€0.20) - 2020/05/24 18:51 UTC [2020/05/24 19:51 CET]
Table ID '45238934' 6-Max Seat #1 is the button
Seat 1: Avery I (€64.81 in chips)
Seat 2: Brandon C (€23.42 in chips)
Seat 3: MiamiBlues (€20.20 in chips)
Seat 4: Trae G (€17.68 in chips)
Seat 5: Kimberly Z (€20.69 in chips)
Brandon C: posts small blind €0.10
MiamiBlues: posts big blind €0.20
*** HOLE CARDS ***
Dealt to Brandon C [8h 2s Jd 8c]
Dealt to MiamiBlues [7d 5h 6s 3h]
Dealt to Trae G [4d Ks Jc 3s]
Dealt to Kimberly Z [6d 2h Qd Qh]
Dealt to Avery I [9c Kh 5s Th]
Trae G: folds
Kimberly Z: folds
Avery I: raises €0.50 to €0.70
Brandon C: folds
MiamiBlues: calls €0.50
*** FLOP *** [6h 5c 7c]
MiamiBlues: checks
Avery I: checks
*** TURN *** [6h 5c 7c] [Td]
MiamiBlues: checks
Avery I: checks
*** RIVER *** [6h 5c 7c Td] [Qc]
MiamiBlues: checks
Avery I: checks
*** SHOWDOWN ***
Avery I shows [9c Kh 5s Th] for Two Pairs [Qc Th Td 5s 5c]
Avery I collected €1.43 from pot
*** SUMMARY ***
Total pot €1.50 | Main pot €1.50 | Side pot €0.00 | Rake €0.07
Board [6h 5c 7c Td Qc]
Seat 4: Trae G folded before Flop
Seat 5: Kimberly Z folded before Flop
Seat 2: Brandon C (small blind) folded before Flop
Seat 1: Avery I (button) showed [9c Kh 5s Th] and won €1.43 with Two Pairs T 5 and Q
Seat 3: MiamiBlues (big blind) mucked [7d 5h 6s 3h] and lost


**** **** **** **** **** **** **** ****


Run It Once Poker Hand #45242310:  Omaha Pot Limit (€0.10/€0.20) - 2020/05/24 18:52 UTC [2020/05/24 19:52 CET]
Table ID '45238934' 6-Max Seat #2 is the button
Seat 1: Avery I (€65.54 in chips)
Seat 2: Brandon C (€23.32 in chips)
Seat 3: MiamiBlues (€20 in chips)
Seat 4: Trae G (€17.68 in chips)
Seat 5: Kimberly Z (€20.69 in chips)
MiamiBlues: posts small blind €0.10
Trae G: posts big blind €0.20
*** HOLE CARDS ***
Dealt to MiamiBlues [3h 7s 7c Jh]
Dealt to Trae G [As 4d 7h 6c]
Dealt to Kimberly Z [6h Ac 2d Kh]
Dealt to Avery I [Ks 9s 3s 4c]
Dealt to Brandon C [Qh Kc Jc 2c]
Kimberly Z: folds
Avery I: folds
Brandon C: raises €0.50 to €0.70
MiamiBlues: folds
Trae G: folds
*** SHOWDOWN ***
Brandon C: mucks hand
Uncalled bet (€0.50) returned to Brandon C
Brandon C collected €0.50 from pot
*** SUMMARY ***
Total pot €0.50 | Main pot €0.50 | Side pot €0.00 | Rake €0.00
Seat 5: Kimberly Z folded before Flop
Seat 1: Avery I folded before Flop
Seat 3: MiamiBlues (small blind) folded before Flop
Seat 4: Trae G (big blind) folded before Flop
Seat 2: Brandon C (button) mucked hand and won €0.50


**** **** **** **** **** **** **** ****


Run It Once Poker Hand #45242318:  Omaha Pot Limit (€0.10/€0.20) - 2020/05/24 18:52 UTC [2020/05/24 19:52 CET]
Table ID '45238934' 6-Max Seat #3 is the button
Seat 1: Avery I (€65.54 in chips)
Seat 2: Brandon C (€23.62 in chips)
Seat 3: MiamiBlues (€20 in chips)
Seat 4: Trae G (€17.48 in chips)
Seat 5: Kimberly Z (€20.69 in chips)
Trae G: posts small blind €0.10
Kimberly Z: posts big blind €0.20
*** HOLE CARDS ***
Dealt to Trae G [2c 9s Td 4h]
Dealt to Kimberly Z [Qh 4d 5c 6s]
Dealt to Avery I [2h Qd As 2s]
Dealt to Brandon C [Ah Qc 9h Jh]
Dealt to MiamiBlues [3s 8h Kh Kd]
Avery I: folds
Brandon C: raises €0.50 to €0.70
MiamiBlues: calls €0.70
Trae G: folds
Kimberly Z: folds
*** FLOP *** [3c Js 3h]
Brandon C: bets €0.81
MiamiBlues: calls €0.81
*** TURN *** [3c Js 3h] [9c]
Brandon C: bets €2.38
MiamiBlues: raises €3.97 to €6.35
Brandon C: raises €15.76 to €22.11 and is all-in
MiamiBlues: calls €12.14 and is all-in
*** RIVER *** [3c Js 3h 9c] [Ac]
*** SHOWDOWN ***
MiamiBlues shows [3s 8h Kh Kd] for Three of Kind [Ac Kh 3s 3h 3c]
Uncalled bet (€3.62) returned to Brandon C
MiamiBlues collected €38.49 from pot
*** SUMMARY ***
Total pot €40.30 | Main pot €40.30 | Side pot €0.00 | Rake €1.81
Board [3c Js 3h 9c Ac]
Seat 1: Avery I folded before Flop
Seat 4: Trae G (small blind) folded before Flop
Seat 5: Kimberly Z (big blind) folded before Flop
Seat 3: MiamiBlues (button) showed [3s 8h Kh Kd] and won €38.49 with Three of Kind 3's and A K
Seat 2: Brandon C mucked [Ah Qc 9h Jh] and lost


**** **** **** **** **** **** **** ****


Run It Once Poker Hand #45242341:  Omaha Pot Limit (€0.10/€0.20) - 2020/05/24 18:53 UTC [2020/05/24 19:53 CET]
Table ID '45238934' 6-Max Seat #4 is the button
Seat 1: Avery I (€65.54 in chips)
Seat 2: Brandon C (€20 in chips)
Seat 3: MiamiBlues (€38.49 in chips)
Seat 4: Trae G (€17.38 in chips)
Seat 5: Kimberly Z (€20.49 in chips)
Seat 6: Chester O (€20 in chips)
Kimberly Z: posts small blind €0.10
Chester O: posts big blind €0.20
*** HOLE CARDS ***
STP added: €0.60
Dealt to Kimberly Z [8s 2c 9h 4s]
Dealt to Chester O [Qs 3c 2d 5c]
Dealt to Avery I [Kd 9d Qd 4h]
Dealt to Brandon C [Qh 2s Js 6s]
Dealt to MiamiBlues [Jc Ah 8c Jd]
Dealt to Trae G [Kh 8h 4c Kc]
Avery I: folds
Brandon C: folds
MiamiBlues: raises €0.50 to €0.70
Trae G: calls €0.70
Kimberly Z: folds
Chester O: folds
*** FLOP *** [5s Ts 3s]
MiamiBlues: bets €0.70
Trae G: folds
MiamiBlues: mucks hand
*** SHOWDOWN ***
MiamiBlues: mucks hand
Uncalled bet (€0.70) returned to MiamiBlues
MiamiBlues collected €2.22 from pot
*** SUMMARY ***
Total pot €2.30 | Main pot €1.70 | Side pot €0.00 | STP €0.60 | Rake €0.08
Board [5s Ts 3s]
Seat 1: Avery I folded before Flop
Seat 2: Brandon C folded before Flop
Seat 5: Kimberly Z (small blind) folded before Flop
Seat 6: Chester O (big blind) folded before Flop
Seat 4: Trae G (button) folded before Turn
Seat 3: MiamiBlues mucked hand and won €2.22


**** **** **** **** **** **** **** ****


Run It Once Poker Hand #45242355:  Omaha Pot Limit (€0.10/€0.20) - 2020/05/24 18:54 UTC [2020/05/24 19:54 CET]
Table ID '45238934' 6-Max Seat #5 is the button
Seat 1: Avery I (€65.54 in chips)
Seat 2: Brandon C (€20 in chips)
Seat 3: MiamiBlues (€40.01 in chips)
Seat 4: Trae G (€16.68 in chips)
Seat 5: Kimberly Z (€20.39 in chips)
Seat 6: Chester O (€20 in chips)
Chester O: posts small blind €0.10
Avery I: posts big blind €0.20
*** HOLE CARDS ***
Dealt to Chester O [Qc 8h Js Ts]
Dealt to Avery I [6s 2h 6h 2s]
Dealt to Brandon C [3h 7s 7d Ah]
Dealt to MiamiBlues [2d 9h Tc Qh]
Dealt to Trae G [As 3d Qd 5h]
Dealt to Kimberly Z [2c Kh 4h 4c]
Brandon C: folds
MiamiBlues: folds
Trae G: folds
Kimberly Z: folds
Chester O: raises €0.40 to €0.60
Avery I: calls €0.40
*** FLOP *** [8c 7c 4s]
Chester O: checks
Avery I: bets €0.86
Chester O: calls €0.86
*** TURN *** [8c 7c 4s] [9d]
Chester O: checks
Avery I: checks
*** RIVER *** [8c 7c 4s 9d] [Jd]
Chester O: bets €2.79
Avery I: folds
Chester O: mucks hand
*** SHOWDOWN ***
Chester O: mucks hand
Uncalled bet (€2.79) returned to Chester O
Chester O collected €2.79 from pot
*** SUMMARY ***
Total pot €2.92 | Main pot €2.92 | Side pot €0.00 | Rake €0.13
Board [8c 7c 4s 9d Jd]
Seat 2: Brandon C folded before Flop
Seat 3: MiamiBlues folded before Flop
Seat 4: Trae G folded before Flop
Seat 5: Kimberly Z (button) folded before Flop
Seat 1: Avery I (big blind) folded during River
Seat 6: Chester O (small blind) mucked hand and won €2.79


**** **** **** **** **** **** **** ****


Run It Once Poker Hand #45242379:  Omaha Pot Limit (€0.10/€0.20) - 2020/05/24 18:55 UTC [2020/05/24 19:55 CET]
Table ID '45238934' 6-Max Seat #6 is the button
Seat 1: Avery I (€64.08 in chips)
Seat 2: Brandon C (€20 in chips)
Seat 3: MiamiBlues (€40.01 in chips)
Seat 4: Trae G (€16.68 in chips)
Seat 5: Kimberly Z (€20.39 in chips)
Seat 6: Chester O (€21.33 in chips)
Avery I: posts small blind €0.10
Brandon C: posts big blind €0.20
*** HOLE CARDS ***
Dealt to Avery I [2h 4c 7s Ah]
Dealt to Brandon C [Jh Js 2s 2d]
Dealt to MiamiBlues [4s Th 8s Td]
Dealt to Trae G [3s 3h 5h Qd]
Dealt to Kimberly Z [7h 7c Ks Qs]
Dealt to Chester O [6s 9s 4d Ts]
MiamiBlues: folds
Trae G: folds
Kimberly Z: folds
Chester O: folds
Avery I: raises €0.40 to €0.60
Brandon C: calls €0.40
*** FLOP *** [8c 5s 5c]
Avery I: checks
Brandon C: bets €0.86
Avery I: folds
Brandon C: mucks hand
*** SHOWDOWN ***
Brandon C: mucks hand
Uncalled bet (€0.86) returned to Brandon C
Brandon C collected €1.15 from pot
*** SUMMARY ***
Total pot €1.20 | Main pot €1.20 | Side pot €0.00 | Rake €0.05
Board [8c 5s 5c]
Seat 3: MiamiBlues folded before Flop
Seat 4: Trae G folded before Flop
Seat 5: Kimberly Z folded before Flop
Seat 6: Chester O (button) folded before Flop
Seat 1: Avery I (small blind) folded before Turn
Seat 2: Brandon C (big blind) mucked hand and won €1.15


**** **** **** **** **** **** **** ****


Run It Once Poker Hand #45242400:  Omaha Pot Limit (€0.10/€0.20) - 2020/05/24 18:56 UTC [2020/05/24 19:56 CET]
Table ID '45238934' 6-Max Seat #1 is the button
Seat 1: Avery I (€63.48 in chips)
Seat 2: Brandon C (€20.55 in chips)
Seat 3: MiamiBlues (€40.01 in chips)
Seat 4: Trae G (€16.68 in chips)
Seat 5: Kimberly Z (€20.39 in chips)
Seat 6: Chester O (€21.33 in chips)
Brandon C: posts small blind €0.10
MiamiBlues: posts big blind €0.20
*** HOLE CARDS ***
Dealt to Brandon C [2c Kc 6d Ah]
Dealt to MiamiBlues [Js 9c 9d 6h]
Dealt to Trae G [4c Qh 6c Jc]
Dealt to Kimberly Z [Tc 8s As 5d]
Dealt to Chester O [3s 7h Ad 9h]
Dealt to Avery I [Kh Ac 4h 7d]
Trae G: folds
Kimberly Z: folds
Chester O: folds
Avery I: raises €0.50 to €0.70
Brandon C: folds
MiamiBlues: folds
*** SHOWDOWN ***
Avery I: mucks hand
Uncalled bet (€0.50) returned to Avery I
Avery I collected €0.50 from pot
*** SUMMARY ***
Total pot €0.50 | Main pot €0.50 | Side pot €0.00 | Rake €0.00
Seat 4: Trae G folded before Flop
Seat 5: Kimberly Z folded before Flop
Seat 6: Chester O folded before Flop
Seat 2: Brandon C (small blind) folded before Flop
Seat 3: MiamiBlues (big blind) folded before Flop
Seat 1: Avery I (button) mucked hand and won €0.50


**** **** **** **** **** **** **** ****


Run It Once Poker Hand #45242409:  Omaha Pot Limit (€0.10/€0.20) - 2020/05/24 18:56 UTC [2020/05/24 19:56 CET]
Table ID '45238934' 6-Max Seat #2 is the button
Seat 1: Avery I (€63.78 in chips)
Seat 2: Brandon C (€20.45 in chips)
Seat 3: MiamiBlues (€39.81 in chips)
Seat 4: Trae G (€16.68 in chips)
Seat 5: Kimberly Z (€20.39 in chips)
Seat 6: Chester O (€21.33 in chips)
MiamiBlues: posts small blind €0.10
Trae G: posts big blind €0.20
*** HOLE CARDS ***
Dealt to MiamiBlues [7s 7c Td 9c]
Dealt to Trae G [Tc 3c 3d 9s]
Dealt to Kimberly Z [Kh 5d 4c 2c]
Dealt to Chester O [7h Ac Qh 8s]
Dealt to Avery I [Jd 4d 5s Jh]
Dealt to Brandon C [5h 4s 2h 8c]
Kimberly Z: folds
Chester O: folds
Avery I: raises €0.50 to €0.70
Brandon C: folds
MiamiBlues: folds
Trae G: folds
*** SHOWDOWN ***
Avery I: mucks hand
Uncalled bet (€0.50) returned to Avery I
Avery I collected €0.50 from pot
*** SUMMARY ***
Total pot €0.50 | Main pot €0.50 | Side pot €0.00 | Rake €0.00
Seat 5: Kimberly Z folded before Flop
Seat 6: Chester O folded before Flop
Seat 2: Brandon C (button) folded before Flop
Seat 3: MiamiBlues (small blind) folded before Flop
Seat 4: Trae G (big blind) folded before Flop
Seat 1: Avery I mucked hand and won €0.50


**** **** **** **** **** **** **** ****


Run It Once Poker Hand #45242415:  Omaha Pot Limit (€0.10/€0.20) - 2020/05/24 18:57 UTC [2020/05/24 19:57 CET]
Table ID '45238934' 6-Max Seat #3 is the button
Seat 1: Avery I (€64.08 in chips)
Seat 2: Brandon C (€20.45 in chips)
Seat 3: MiamiBlues (€39.71 in chips)
Seat 4: Trae G (€16.48 in chips)
Seat 5: Kimberly Z (€20.39 in chips)
Seat 6: Chester O (€21.33 in chips)
Trae G: posts small blind €0.10
Kimberly Z: posts big blind €0.20
*** HOLE CARDS ***
Dealt to Trae G [Ks 2s 2d Js]
Dealt to Kimberly Z [Tc 4h Jh 4c]
Dealt to Chester O [Td 8s 8h 7h]
Dealt to Avery I [9c 8d Ad 6c]
Dealt to Brandon C [Ts Jc 9h 5s]
Dealt to MiamiBlues [6s 3c Kh Qd]
Chester O: raises €0.50 to €0.70
Avery I: calls €0.70
Brandon C: raises €2.40 to €3.10
MiamiBlues: folds
Trae G: folds
Kimberly Z: folds
Chester O: folds
Avery I: calls €2.40
*** FLOP *** [7s 8c 7d]
Avery I: bets €3.44
Brandon C: raises €13.76 to €17.20
Avery I: raises €13.76 to €30.96
Brandon C: calls €0.15
*** TURN *** [7s 8c 7d] [Kd]
Avery I: checks
Brandon C: checks and is all-in
*** RIVER *** [7s 8c 7d Kd] [4s]
*** SHOWDOWN ***
Avery I shows [9c 8d Ad 6c] for Two Pairs [Ad 8d 8c 7s 7d]
Uncalled bet (€13.61) returned to Avery I
Avery I collected €40.01 from pot
*** SUMMARY ***
Total pot €41.90 | Main pot €41.90 | Side pot €0.00 | Rake €1.89
Board [7s 8c 7d Kd 4s]
Seat 3: MiamiBlues (button) folded before Flop
Seat 4: Trae G (small blind) folded before Flop
Seat 5: Kimberly Z (big blind) folded before Flop
Seat 6: Chester O folded before Flop
Seat 1: Avery I showed [9c 8d Ad 6c] and won €40.01 with Two Pairs 8 7 and A
Seat 2: Brandon C mucked [Ts Jc 9h 5s] and lost


**** **** **** **** **** **** **** ****


Run It Once Poker Hand #45242433:  Omaha Pot Limit (€0.10/€0.20) - 2020/05/24 18:57 UTC [2020/05/24 19:57 CET]
Table ID '45238934' 6-Max Seat #4 is the button
Seat 1: Avery I (€83.64 in chips)
Seat 2: Brandon C (€20 in chips)
Seat 3: MiamiBlues (€39.71 in chips)
Seat 4: Trae G (€16.38 in chips)
Seat 5: Kimberly Z (€20.19 in chips)
Seat 6: Chester O (€20.63 in chips)
Kimberly Z: posts small blind €0.10
Chester O: posts big blind €0.20
*** HOLE CARDS ***
Dealt to Kimberly Z [As Qd Qh 8d]
Dealt to Chester O [Jh 2h 9c 5h]
Dealt to Avery I [3d 7c Th 5c]
Dealt to Brandon C [Ks 8h Js 8s]
Dealt to MiamiBlues [Kh Kc 4h 3h]
Dealt to Trae G [7d Ah Td 4d]
Avery I: folds
Brandon C: raises €0.50 to €0.70
MiamiBlues: calls €0.70
Trae G: folds
Kimberly Z: folds
Chester O: folds
*** FLOP *** [4s 4c 9h]
Brandon C: checks
MiamiBlues: bets €0.81
Brandon C: folds
MiamiBlues: mucks hand
*** SHOWDOWN ***
MiamiBlues: mucks hand
Uncalled bet (€0.81) returned to MiamiBlues
MiamiBlues collected €1.62 from pot
*** SUMMARY ***
Total pot €1.70 | Main pot €1.70 | Side pot €0.00 | Rake €0.08
Board [4s 4c 9h]
Seat 1: Avery I folded before Flop
Seat 4: Trae G (button) folded before Flop
Seat 5: Kimberly Z (small blind) folded before Flop
Seat 6: Chester O (big blind) folded before Flop
Seat 2: Brandon C folded before Turn
Seat 3: MiamiBlues mucked hand and won €1.62


**** **** **** **** **** **** **** ****


Run It Once Poker Hand #45242451:  Omaha Pot Limit (€0.10/€0.20) - 2020/05/24 18:58 UTC [2020/05/24 19:58 CET]
Table ID '45238934' 6-Max Seat #5 is the button
Seat 1: Avery I (€83.64 in chips)
Seat 2: Brandon C (€20 in chips)
Seat 3: MiamiBlues (€40.63 in chips)
Seat 4: Trae G (€16.38 in chips)
Seat 5: Kimberly Z (€20.09 in chips)
Seat 6: Chester O (€20.43 in chips)
Chester O: posts small blind €0.10
Avery I: posts big blind €0.20
*** HOLE CARDS ***
Dealt to Chester O [5d 4h 9d Qc]
Dealt to Avery I [Tc Ks 5s 6c]
Dealt to Brandon C [As 7d 2c Th]
Dealt to MiamiBlues [Ah 3d 6s 3s]
Dealt to Trae G [5h Js 8c 8d]
Dealt to Kimberly Z [Kc 3h 7s Jd]
Brandon C: folds
MiamiBlues: folds
Trae G: folds
Kimberly Z: folds
Chester O: folds
*** SHOWDOWN ***
Avery I: mucks hand
Avery I collected €0.30 from pot
*** SUMMARY ***
Total pot €0.30 | Main pot €0.30 | Side pot €0.00 | Rake €0.00
Seat 2: Brandon C folded before Flop
Seat 3: MiamiBlues folded before Flop
Seat 4: Trae G folded before Flop
Seat 5: Kimberly Z (button) folded before Flop
Seat 6: Chester O (small blind) folded before Flop
Seat 1: Avery I (big blind) mucked hand and won €0.30


**** **** **** **** **** **** **** ****


Run It Once Poker Hand #45242472:  Omaha Pot Limit (€0.10/€0.20) - 2020/05/24 18:59 UTC [2020/05/24 19:59 CET]
Table ID '45238934' 6-Max Seat #6 is the button
Seat 1: Avery I (€83.74 in chips)
Seat 2: Brandon C (€20 in chips)
Seat 3: MiamiBlues (€40.63 in chips)
Seat 4: Trae G (€16.38 in chips)
Seat 5: Kimberly Z (€20.09 in chips)
Seat 6: Chester O (€20.33 in chips)
Avery I: posts small blind €0.10
Brandon C: posts big blind €0.20
*** HOLE CARDS ***
Dealt to Avery I [Ac Ks 4c Tc]
Dealt to Brandon C [5s Td 4s 2h]
Dealt to MiamiBlues [Ad 8c 6s Jd]
Dealt to Trae G [6h Qc 5h 8s]
Dealt to Kimberly Z [7c Jh Th 4d]
Dealt to Chester O [7s Js 2c Qd]
MiamiBlues: folds
Trae G: folds
Kimberly Z: folds
Chester O: folds
Avery I: raises €0.40 to €0.60
Brandon C: folds
*** SHOWDOWN ***
Avery I: mucks hand
Uncalled bet (€0.40) returned to Avery I
Avery I collected €0.40 from pot
*** SUMMARY ***
Total pot €0.40 | Main pot €0.40 | Side pot €0.00 | Rake €0.00
Seat 3: MiamiBlues folded before Flop
Seat 4: Trae G folded before Flop
Seat 5: Kimberly Z folded before Flop
Seat 6: Chester O (button) folded before Flop
Seat 2: Brandon C (big blind) folded before Flop
Seat 1: Avery I (small blind) mucked hand and won €0.40


**** **** **** **** **** **** **** ****


Run It Once Poker Hand #45242481:  Omaha Pot Limit (€0.10/€0.20) - 2020/05/24 18:59 UTC [2020/05/24 19:59 CET]
Table ID '45238934' 6-Max Seat #1 is the button
Seat 1: Avery I (€83.94 in chips)
Seat 2: Brandon C (€20 in chips)
Seat 3: MiamiBlues (€40.63 in chips)
Seat 4: Trae G (€16.38 in chips)
Seat 6: Chester O (€20.33 in chips)
Brandon C: posts small blind €0.10
MiamiBlues: posts big blind €0.20
*** HOLE CARDS ***
Dealt to Brandon C [Qs 7d 8h 3s]
Dealt to MiamiBlues [3d Th 7c Qc]
Dealt to Trae G [Ac As 6h 6c]
Dealt to Chester O [Kc 7s 8c 9d]
Dealt to Avery I [4c Ks Qh Ts]
Trae G: raises €0.50 to €0.70
Chester O: folds
Avery I: folds
Brandon C: folds
MiamiBlues: folds
*** SHOWDOWN ***
Trae G: mucks hand
Uncalled bet (€0.50) returned to Trae G
Trae G collected €0.50 from pot
*** SUMMARY ***
Total pot €0.50 | Main pot €0.50 | Side pot €0.00 | Rake €0.00
Seat 6: Chester O folded before Flop
Seat 1: Avery I (button) folded before Flop
Seat 2: Brandon C (small blind) folded before Flop
Seat 3: MiamiBlues (big blind) folded before Flop
Seat 4: Trae G mucked hand and won €0.50


**** **** **** **** **** **** **** ****


Run It Once Poker Hand #45242489:  Omaha Pot Limit (€0.10/€0.20) - 2020/05/24 19:00 UTC [2020/05/24 20:00 CET]
Table ID '45238934' 6-Max Seat #2 is the button
Seat 1: Avery I (€83.94 in chips)
Seat 2: Brandon C (€20 in chips)
Seat 3: MiamiBlues (€40.43 in chips)
Seat 4: Trae G (€16.68 in chips)
Seat 6: Chester O (€20.33 in chips)
MiamiBlues: posts small blind €0.10
Trae G: posts big blind €0.20
*** HOLE CARDS ***
Dealt to MiamiBlues [7h 3s 7c Kc]
Dealt to Trae G [4d 6c 5s 2s]
Dealt to Chester O [6d Jh Td 8s]
Dealt to Avery I [5d Ks 9c Qc]
Dealt to Brandon C [9s Ts 8h 2h]
Chester O: folds
Avery I: raises €0.50 to €0.70
Brandon C: raises €1.70 to €2.40
MiamiBlues: folds
Trae G: folds
Avery I: calls €1.70
*** FLOP *** [3d 8c Ad]
Avery I: checks
Brandon C: checks
*** TURN *** [3d 8c Ad] [Ah]
Avery I: checks
Brandon C: checks
*** RIVER *** [3d 8c Ad Ah] [Kh]
Avery I: checks
Brandon C: checks
*** SHOWDOWN ***
Avery I shows [5d Ks 9c Qc] for Two Pairs [Ah Ad Ks Kh Qc]
Avery I collected €4.87 from pot
*** SUMMARY ***
Total pot €5.10 | Main pot €5.10 | Side pot €0.00 | Rake €0.23
Board [3d 8c Ad Ah Kh]
Seat 6: Chester O folded before Flop
Seat 3: MiamiBlues (small blind) folded before Flop
Seat 4: Trae G (big blind) folded before Flop
Seat 1: Avery I showed [5d Ks 9c Qc] and won €4.87 with Two Pairs A K and Q
Seat 2: Brandon C (button) mucked [9s Ts 8h 2h] and lost


**** **** **** **** **** **** **** ****


Run It Once Poker Hand #45242522:  Omaha Pot Limit (€0.10/€0.20) - 2020/05/24 19:01 UTC [2020/05/24 20:01 CET]
Table ID '45238934' 6-Max Seat #3 is the button
Seat 1: Avery I (€86.41 in chips)
Seat 2: Brandon C (€20 in chips)
Seat 3: MiamiBlues (€40.33 in chips)
Seat 4: Trae G (€16.48 in chips)
Seat 6: Chester O (€20.33 in chips)
Trae G: posts small blind €0.10
Chester O: posts big blind €0.20
*** HOLE CARDS ***
Dealt to Trae G [2s 9s 4c Qh]
Dealt to Chester O [3c 4d 7h Js]
Dealt to Avery I [7d 8h Ah As]
Dealt to Brandon C [8s 6c 3h 3d]
Dealt to MiamiBlues [5h Jh Ks 5c]
Avery I: raises €0.50 to €0.70
Brandon C: folds
MiamiBlues: folds
Trae G: folds
Chester O: folds
*** SHOWDOWN ***
Avery I: mucks hand
Uncalled bet (€0.50) returned to Avery I
Avery I collected €0.50 from pot
*** SUMMARY ***
Total pot €0.50 | Main pot €0.50 | Side pot €0.00 | Rake €0.00
Seat 2: Brandon C folded before Flop
Seat 3: MiamiBlues (button) folded before Flop
Seat 4: Trae G (small blind) folded before Flop
Seat 6: Chester O (big blind) folded before Flop
Seat 1: Avery I mucked hand and won €0.50


**** **** **** **** **** **** **** ****


Run It Once Poker Hand #45242530:  Omaha Pot Limit (€0.10/€0.20) - 2020/05/24 19:01 UTC [2020/05/24 20:01 CET]
Table ID '45238934' 6-Max Seat #4 is the button
Seat 1: Avery I (€86.71 in chips)
Seat 2: Brandon C (€20 in chips)
Seat 3: MiamiBlues (€40.33 in chips)
Seat 4: Trae G (€16.38 in chips)
Seat 6: Chester O (€20.13 in chips)
Chester O: posts small blind €0.10
Avery I: posts big blind €0.20
*** HOLE CARDS ***
Dealt to Chester O [Ad 8h 2h 2s]
Dealt to Avery I [3c 8d 3d 3h]
Dealt to Brandon C [As Th 5h 9h]
Dealt to MiamiBlues [8s Qc 7s Kh]
Dealt to Trae G [9d 4h 4c Ts]
Brandon C: folds
MiamiBlues: folds
Trae G: folds
Chester O: folds
*** SHOWDOWN ***
Avery I: mucks hand
Avery I collected €0.30 from pot
*** SUMMARY ***
Total pot €0.30 | Main pot €0.30 | Side pot €0.00 | Rake €0.00
Seat 2: Brandon C folded before Flop
Seat 3: MiamiBlues folded before Flop
Seat 4: Trae G (button) folded before Flop
Seat 6: Chester O (small blind) folded before Flop
Seat 1: Avery I (big blind) mucked hand and won €0.30


**** **** **** **** **** **** **** ****


Run It Once Poker Hand #45242537:  Omaha Pot Limit (€0.10/€0.20) - 2020/05/24 19:01 UTC [2020/05/24 20:01 CET]
Table ID '45238934' 6-Max Seat #6 is the button
Seat 1: Avery I (€86.81 in chips)
Seat 2: Brandon C (€20 in chips)
Seat 3: MiamiBlues (€40.33 in chips)
Seat 4: Trae G (€16.38 in chips)
Seat 6: Chester O (€20.03 in chips)
Avery I: posts small blind €0.10
Brandon C: posts big blind €0.20
*** HOLE CARDS ***
Dealt to Avery I [9c 8d 7d Kc]
Dealt to Brandon C [As 5s 2s 8s]
Dealt to MiamiBlues [4h 2d Qd 2h]
Dealt to Trae G [6h 3c 7c 4c]
Dealt to Chester O [3s Qs 8c Jh]
MiamiBlues: folds
Trae G: folds
Chester O: folds
Avery I: raises €0.40 to €0.60
Brandon C: folds
*** SHOWDOWN ***
Avery I: mucks hand
Uncalled bet (€0.40) returned to Avery I
Avery I collected €0.40 from pot
*** SUMMARY ***
Total pot €0.40 | Main pot €0.40 | Side pot €0.00 | Rake €0.00
Seat 3: MiamiBlues folded before Flop
Seat 4: Trae G folded before Flop
Seat 6: Chester O (button) folded before Flop
Seat 2: Brandon C (big blind) folded before Flop
Seat 1: Avery I (small blind) mucked hand and won €0.40


**** **** **** **** **** **** **** ****


Run It Once Poker Hand #45242544:  Omaha Pot Limit (€0.10/€0.20) - 2020/05/24 19:02 UTC [2020/05/24 20:02 CET]
Table ID '45238934' 6-Max Seat #1 is the button
Seat 1: Avery I (€87.01 in chips)
Seat 2: Brandon C (€20 in chips)
Seat 3: MiamiBlues (€40.33 in chips)
Seat 4: Trae G (€16.38 in chips)
Seat 6: Chester O (€20.03 in chips)
Brandon C: posts small blind €0.10
MiamiBlues: posts big blind €0.20
*** HOLE CARDS ***
Dealt to Brandon C [Qc 2d 9s Qd]
Dealt to MiamiBlues [Kh 4s 3d 4h]
Dealt to Trae G [2h 3c 8s 2c]
Dealt to Chester O [5c 4c 3h Qh]
Dealt to Avery I [3s 8d 8h 6c]
Trae G: folds
Chester O: raises €0.40 to €0.60
Avery I: folds
Brandon C: folds
MiamiBlues: folds
*** SHOWDOWN ***
Chester O: mucks hand
Uncalled bet (€0.40) returned to Chester O
Chester O collected €0.50 from pot
*** SUMMARY ***
Total pot €0.50 | Main pot €0.50 | Side pot €0.00 | Rake €0.00
Seat 4: Trae G folded before Flop
Seat 1: Avery I (button) folded before Flop
Seat 2: Brandon C (small blind) folded before Flop
Seat 3: MiamiBlues (big blind) folded before Flop
Seat 6: Chester O mucked hand and won €0.50


**** **** **** **** **** **** **** ****


Run It Once Poker Hand #45242557:  Omaha Pot Limit (€0.10/€0.20) - 2020/05/24 19:02 UTC [2020/05/24 20:02 CET]
Table ID '45238934' 6-Max Seat #2 is the button
Seat 1: Avery I (€87.01 in chips)
Seat 2: Brandon C (€20 in chips)
Seat 3: MiamiBlues (€40.13 in chips)
Seat 4: Trae G (€16.38 in chips)
Seat 6: Chester O (€20.33 in chips)
MiamiBlues: posts small blind €0.10
Trae G: posts big blind €0.20
*** HOLE CARDS ***
Dealt to MiamiBlues [3d 6d 4s As]
Dealt to Trae G [4c 7h 7d Ad]
Dealt to Chester O [8h 3s 5c 8s]
Dealt to Avery I [2d Jc Jd Qs]
Dealt to Brandon C [4h 5s 9d 2c]
Chester O: folds
Avery I: raises €0.50 to €0.70
Brandon C: folds
MiamiBlues: folds
Trae G: folds
*** SHOWDOWN ***
Avery I: mucks hand
Uncalled bet (€0.50) returned to Avery I
Avery I collected €0.50 from pot
*** SUMMARY ***
Total pot €0.50 | Main pot €0.50 | Side pot €0.00 | Rake €0.00
Seat 6: Chester O folded before Flop
Seat 2: Brandon C (button) folded before Flop
Seat 3: MiamiBlues (small blind) folded before Flop
Seat 4: Trae G (big blind) folded before Flop
Seat 1: Avery I mucked hand and won €0.50


**** **** **** **** **** **** **** ****


Run It Once Poker Hand #45242564:  Omaha Pot Limit (€0.10/€0.20) - 2020/05/24 19:02 UTC [2020/05/24 20:02 CET]
Table ID '45238934' 6-Max Seat #3 is the button
Seat 1: Avery I (€87.31 in chips)
Seat 2: Brandon C (€20 in chips)
Seat 3: MiamiBlues (€40.03 in chips)
Seat 4: Trae G (€16.18 in chips)
Seat 6: Chester O (€20.33 in chips)
Trae G: posts small blind €0.10
Chester O: posts big blind €0.20
*** HOLE CARDS ***
Dealt to Trae G [Qh Ac Kh 4d]
Dealt to Chester O [5d 6s Js Th]
Dealt to Avery I [2c 2s 8h Qc]
Dealt to Brandon C [4h Td 7d 3d]
Dealt to MiamiBlues [6d Kd 9d 7h]
Avery I: folds
Brandon C: folds
MiamiBlues: raises €0.50 to €0.70
Trae G: folds
Chester O: folds
*** SHOWDOWN ***
MiamiBlues: mucks hand
Uncalled bet (€0.50) returned to MiamiBlues
MiamiBlues collected €0.50 from pot
*** SUMMARY ***
Total pot €0.50 | Main pot €0.50 | Side pot €0.00 | Rake €0.00
Seat 1: Avery I folded before Flop
Seat 2: Brandon C folded before Flop
Seat 4: Trae G (small blind) folded before Flop
Seat 6: Chester O (big blind) folded before Flop
Seat 3: MiamiBlues (button) mucked hand and won €0.50


**** **** **** **** **** **** **** ****


Run It Once Poker Hand #45242571:  Omaha Pot Limit (€0.10/€0.20) - 2020/05/24 19:03 UTC [2020/05/24 20:03 CET]
Table ID '45238934' 6-Max Seat #4 is the button
Seat 1: Avery I (€87.31 in chips)
Seat 2: Brandon C (€20 in chips)
Seat 3: MiamiBlues (€40.33 in chips)
Seat 4: Trae G (€16.08 in chips)
Seat 6: Chester O (€20.13 in chips)
Chester O: posts small blind €0.10
Avery I: posts big blind €0.20
*** HOLE CARDS ***
Dealt to Chester O [Kc 8c 8d 7h]
Dealt to Avery I [5d 8h Ts Jc]
Dealt to Brandon C [As 5s Jd Td]
Dealt to MiamiBlues [3h Qc 2d 5h]
Dealt to Trae G [7d Ad Qs 4h]
Brandon C: raises €0.50 to €0.70
MiamiBlues: folds
Trae G: folds
Chester O: folds
Avery I: folds
*** SHOWDOWN ***
Brandon C: mucks hand
Uncalled bet (€0.50) returned to Brandon C
Brandon C collected €0.50 from pot
*** SUMMARY ***
Total pot €0.50 | Main pot €0.50 | Side pot €0.00 | Rake €0.00
Seat 3: MiamiBlues folded before Flop
Seat 4: Trae G (button) folded before Flop
Seat 6: Chester O (small blind) folded before Flop
Seat 1: Avery I (big blind) folded before Flop
Seat 2: Brandon C mucked hand and won €0.50


**** **** **** **** **** **** **** ****


Run It Once Poker Hand #45242577:  Omaha Pot Limit (€0.10/€0.20) - 2020/05/24 19:03 UTC [2020/05/24 20:03 CET]
Table ID '45238934' 6-Max Seat #6 is the button
Seat 1: Avery I (€87.11 in chips)
Seat 2: Brandon C (€20.30 in chips)
Seat 3: MiamiBlues (€40.33 in chips)
Seat 4: Trae G (€16.08 in chips)
Seat 6: Chester O (€20.03 in chips)
Avery I: posts small blind €0.10
Brandon C: posts big blind €0.20
*** HOLE CARDS ***
Dealt to Avery I [2c As 3d 2s]
Dealt to Brandon C [Js Kh Ts 4h]
Dealt to MiamiBlues [4s 6s 7s 8h]
Dealt to Trae G [Kc Th 7h 8c]
Dealt to Chester O [Ac Ks 9c 5s]
MiamiBlues: folds
Trae G: raises €0.50 to €0.70
Chester O: calls €0.70
Avery I: folds
Brandon C: calls €0.50
*** FLOP *** [8s 5c 8d]
Brandon C: checks
Trae G: bets €1.05
Chester O: folds
Brandon C: folds
Trae G: mucks hand
*** SHOWDOWN ***
Trae G: mucks hand
Uncalled bet (€1.05) returned to Trae G
Trae G collected €2.10 from pot
*** SUMMARY ***
Total pot €2.20 | Main pot €2.20 | Side pot €0.00 | Rake €0.10
Board [8s 5c 8d]
Seat 3: MiamiBlues folded before Flop
Seat 1: Avery I (small blind) folded before Flop
Seat 6: Chester O (button) folded before Turn
Seat 2: Brandon C (big blind) folded before Turn
Seat 4: Trae G mucked hand and won €2.10


**** **** **** **** **** **** **** ****


Run It Once Poker Hand #45243639:  Omaha Pot Limit (€0.10/€0.20) - 2020/05/24 19:04 UTC [2020/05/24 20:04 CET]
Table ID '45238934' 6-Max Seat #1 is the button
Seat 1: Avery I (€87.01 in chips)
Seat 2: Brandon C (€20 in chips)
Seat 3: MiamiBlues (€40.33 in chips)
Seat 4: Trae G (€17.48 in chips)
Seat 6: Chester O (€20 in chips)
Brandon C: posts small blind €0.10
MiamiBlues: posts big blind €0.20
*** HOLE CARDS ***
Dealt to Brandon C [Kc 7c 2h 9s]
Dealt to MiamiBlues [Qh Qc Ah Jc]
Dealt to Trae G [8c Kh Td Tc]
Dealt to Chester O [Ad 3d 2c 6c]
Dealt to Avery I [5d 2s Jd Jh]
Trae G: folds
Chester O: raises €0.50 to €0.70
Avery I: folds
Brandon C: folds
MiamiBlues: raises €1.50 to €2.20
Chester O: calls €1.50
*** FLOP *** [3c Th 2d]
MiamiBlues: bets €1.50
Chester O: raises €5.48 to €6.98
MiamiBlues: folds
Chester O: mucks hand
*** SHOWDOWN ***
Chester O: mucks hand
Uncalled bet (€5.48) returned to Chester O
Chester O collected €7.16 from pot
*** SUMMARY ***
Total pot €7.50 | Main pot €7.50 | Side pot €0.00 | Rake €0.34
Board [3c Th 2d]
Seat 4: Trae G folded before Flop
Seat 1: Avery I (button) folded before Flop
Seat 2: Brandon C (small blind) folded before Flop
Seat 3: MiamiBlues (big blind) folded before Turn
Seat 6: Chester O mucked hand and won €7.16


**** **** **** **** **** **** **** ****


Run It Once Poker Hand #45243674:  Omaha Pot Limit (€0.10/€0.20) - 2020/05/24 19:05 UTC [2020/05/24 20:05 CET]
Table ID '45238934' 6-Max Seat #2 is the button
Seat 1: Avery I (€87.01 in chips)
Seat 2: Brandon C (€20 in chips)
Seat 3: MiamiBlues (€36.63 in chips)
Seat 4: Trae G (€17.48 in chips)
Seat 6: Chester O (€23.46 in chips)
MiamiBlues: posts small blind €0.10
Trae G: posts big blind €0.20
*** HOLE CARDS ***
Dealt to MiamiBlues [8d 7h Ad 4s]
Dealt to Trae G [9c Ks 8c 4h]
Dealt to Chester O [3c 7c 5d 2h]
Dealt to Avery I [Jd Ac 6d 5c]
Dealt to Brandon C [Qs 2s 9d Jh]
Chester O: folds
Avery I: raises €0.50 to €0.70
Brandon C: folds
MiamiBlues: folds
Trae G: folds
*** SHOWDOWN ***
Avery I: mucks hand
Uncalled bet (€0.50) returned to Avery I
Avery I collected €0.50 from pot
*** SUMMARY ***
Total pot €0.50 | Main pot €0.50 | Side pot €0.00 | Rake €0.00
Seat 6: Chester O folded before Flop (timeout)
Seat 2: Brandon C (button) folded before Flop
Seat 3: MiamiBlues (small blind) folded before Flop
Seat 4: Trae G (big blind) folded before Flop
Seat 1: Avery I mucked hand and won €0.50


**** **** **** **** **** **** **** ****


Run It Once Poker Hand #45243684:  Omaha Pot Limit (€0.10/€0.20) - 2020/05/24 19:05 UTC [2020/05/24 20:05 CET]
Table ID '45238934' 6-Max Seat #3 is the button
Seat 1: Avery I (€87.31 in chips)
Seat 2: Brandon C (€20 in chips)
Seat 3: MiamiBlues (€36.53 in chips)
Seat 4: Trae G (€17.28 in chips)
Seat 5: Kimberly Z (€20.09 in chips)
Seat 6: Chester O (€23.46 in chips) - Sitting Out
Trae G: posts small blind €0.10
Kimberly Z: posts big blind €0.20
*** HOLE CARDS ***
Dealt to Trae G [Ad Ac 5s 4d]
Dealt to Kimberly Z [3h Qh Jh Ah]
Dealt to Avery I [5c 4s 3s 9h]
Dealt to Brandon C [2s Kd Kc 7c]
Dealt to MiamiBlues [8h 6s 2c Jd]
Avery I: folds
Brandon C: raises €0.50 to €0.70
MiamiBlues: folds
Trae G: raises €1.60 to €2.30
Kimberly Z: folds
Brandon C: calls €1.60
*** FLOP *** [Qd Jc Ks]
Trae G: bets €2.29
Brandon C: raises €9.16 to €11.45
Trae G: folds
Brandon C: mucks hand
*** SHOWDOWN ***
Brandon C: mucks hand
Uncalled bet (€9.16) returned to Brandon C
Brandon C collected €8.96 from pot
*** SUMMARY ***
Total pot €9.38 | Main pot €9.38 | Side pot €0.00 | Rake €0.42
Board [Qd Jc Ks]
Seat 1: Avery I folded before Flop
Seat 3: MiamiBlues (button) folded before Flop
Seat 5: Kimberly Z (big blind) folded before Flop
Seat 4: Trae G (small blind) folded before Turn
Seat 2: Brandon C mucked hand and won €8.96


**** **** **** **** **** **** **** ****


Run It Once Poker Hand #45243701:  Omaha Pot Limit (€0.10/€0.20) - 2020/05/24 19:06 UTC [2020/05/24 20:06 CET]
Table ID '45238934' 6-Max Seat #4 is the button
Seat 1: Avery I (€87.31 in chips)
Seat 2: Brandon C (€24.37 in chips)
Seat 3: MiamiBlues (€36.53 in chips)
Seat 4: Trae G (€12.69 in chips)
Seat 5: Kimberly Z (€19.89 in chips)
Seat 6: Chester O (€23.46 in chips) - Sitting Out
Kimberly Z: posts small blind €0.10
Avery I: posts big blind €0.20
*** HOLE CARDS ***
Dealt to Kimberly Z [5d Ah 2s 9h]
Dealt to Avery I [8s 6h Qd 7s]
Dealt to Brandon C [8c Ac Th 2d]
Dealt to MiamiBlues [Kd 7h Jh Qc]
Dealt to Trae G [5s 2c 2h Jc]
Brandon C: folds
MiamiBlues: raises €0.50 to €0.70
Trae G: folds
Kimberly Z: folds
Avery I: folds
*** SHOWDOWN ***
MiamiBlues: mucks hand
Uncalled bet (€0.50) returned to MiamiBlues
MiamiBlues collected €0.50 from pot
*** SUMMARY ***
Total pot €0.50 | Main pot €0.50 | Side pot €0.00 | Rake €0.00
Seat 2: Brandon C folded before Flop
Seat 4: Trae G (button) folded before Flop
Seat 5: Kimberly Z (small blind) folded before Flop
Seat 1: Avery I (big blind) folded before Flop
Seat 3: MiamiBlues mucked hand and won €0.50


**** **** **** **** **** **** **** ****


Run It Once Poker Hand #45243714:  Omaha Pot Limit (€0.10/€0.20) - 2020/05/24 19:06 UTC [2020/05/24 20:06 CET]
Table ID '45238934' 6-Max Seat #5 is the button
Seat 1: Avery I (€87.11 in chips)
Seat 2: Brandon C (€24.37 in chips)
Seat 3: MiamiBlues (€36.83 in chips)
Seat 4: Trae G (€12.69 in chips)
Seat 5: Kimberly Z (€19.79 in chips)
Avery I: posts small blind €0.10
Brandon C: posts big blind €0.20
*** HOLE CARDS ***
Dealt to Avery I [Qs 2d 9s 3s]
Dealt to Brandon C [9c 8c 7d 5s]
Dealt to MiamiBlues [Ad Qh 3h 2c]
Dealt to Trae G [Ac 8h Kd Ks]
Dealt to Kimberly Z [8s Ts Jc Kh]
MiamiBlues: folds
Trae G: raises €0.50 to €0.70
Kimberly Z: calls €0.70
Avery I: folds
Brandon C: calls €0.50
*** FLOP *** [Tc Kc Qd]
Brandon C: checks
Trae G: checks
Kimberly Z: checks
*** TURN *** [Tc Kc Qd] [6c]
Brandon C: checks
Trae G: bets €2.10
Kimberly Z: folds
Brandon C: calls €2.10
*** RIVER *** [Tc Kc Qd 6c] [7c]
Brandon C: checks
Trae G: checks
*** SHOWDOWN ***
Brandon C shows [9c 8c 7d 5s] for Straight Flush [Tc 9c 8c 7c 6c]
Brandon C collected €6.11 from pot
*** SUMMARY ***
Total pot €6.40 | Main pot €6.40 | Side pot €0.00 | Rake €0.29
Board [Tc Kc Qd 6c 7c]
Seat 3: MiamiBlues folded before Flop
Seat 1: Avery I (small blind) folded before Flop
Seat 5: Kimberly Z (button) folded before River
Seat 2: Brandon C (big blind) showed [9c 8c 7d 5s] and won €6.11 with Straight Flush 6 to T
Seat 4: Trae G mucked [Ac 8h Kd Ks] and lost